#indices	#indices
#dollarindex	#dollar index
#lets	#lets
#hillaryindicment	#hillary indictment (hillary get sued)
#index	#index
#indexes	#indexes
#indicators	#indicators
#forexaffiliate	#forex(foreign exchange) affiliate
#domainsindex	#domains index
#chivstor	#chivstor
#atpchallenger	#atpchallenger
#stocks	#stocks
#stock	#stock
#forex	#forex(foreign exchange)
#forextradingonline	#forex(foreign exchange) trading online
#pindicks	#pindicks
#indicud	#indicud
#fxtradingnews	#fx(foreign exchange) trading news
#spx500	#spx500
#oneofthebest	#one of the best
#thebestof	#the best of
#freedomfighter	#freedom fighter
#rip	#rip
#incharge	#in charge
#bestyet	#best yet
#bestoftheday	#best of the day
#youarethebest	#you are the best
#pointless	#pointless
#thebestofthebest	#the best of the best
#thebestofme	#the best of me
#lovesosa	#lovesosa
#top5ever	#top 5 ever
#ajfansforever	#aj fans forever
#weloveaj	#we love aj
#arcticmonkeys	#arcticmonkeys
#worldsbest	#worlds best
#maga	#make american great again, a political promise from Donald Trump
#letsgo	#lets go
#draintheswamp	#drain the swamp (a political promise from Donald Trump)
#ccot	#Christian conservatives on twitter, related to Donald Trump
#magaveteran	#maga(MAGA: make american great again) veteran
#traitorssupporttraitortrump	#traitors support traitor trump
#magamorons	#maga(MAGA: make american great again) are stupid people
#americafirst	#america first
#standwithtrump	#stand with trump
#maga3x	#an event which celebrating Donald Trump won the election
#trumpsupporter	#trump supporter
#maga13	#maga13 (please read the tweets to get the meaning)
#godblessall	#god bless all
#tcot	#Top Conservatives on Twitter, related to Donald Trump
#maga2020	#maga2020 (please read the tweets to get the meaning)
#chocolatecake	#chocolate cake
#magaterrorists	#maga(MAGA: make american great again) terrorists
#trump	#trump
#maga2013	#maga2013 (please read the tweets to get the meaning)
#feelspecial	#feel special
#feelingspecial	#feeling special
#futurecities	#futurecities
#twice	#twice
#bestfeeling	#best feeling
#nayeon	#nayeon
#imspecial	#i m special
#somethingspecial	#some thing special
#confrontation	#confrontation
#ifeelspecial	#i feel special
#ifeelloved	#i feel loved
#feellovely	#feel lovely
#firstwarn3	#first warn3
#special	#special
#imaging	#imaging
#medicalimaging	#medical imaging
#radiologists	#radiologists
#thermal	#thermal
#vogueteam	#vogue team
#radiography	#radiography
#job	#job
#radiology	#radiology
#yavapairegionalmedicalcenter	#yavapai regional medical center
#scans	#scans
#mri	#mri
#camilabestfans	#camila best fans
#miamiweather	#miami weather
#visualisation	#visualisation
#liberals	#liberals
#thingsyoumighthearaliberalsay	#things you might hear a liberalsay
#conservatives	#conservatives
#stupidliberals	#stupid liberals
#bcliberals	#British Columbia Liberal Party
#thingsyoucanlearnfromliberals	#things you can learn from liberals
#liberalsgetupsetwhen	#liberals get upset when
#socialists	#socialists (people who support socialism)
#radicalleft	#radical left (aggresive left wing; opposite of conservatives)
#enlisted	#enlisted
#bustweetstl	#bustweetstl
#centrist	#centrist (between liberals and conservatives)
#liberaldemocrats	#liberal democrats (one of the main British political parties)
#democrats	#democrats
#badintentions	#bad intentions
#liberalsunite	#liberals unite
#openaccess	#open access
#openaccesstoyemen	#open access to yemen
#bigimmigrationrow	#big immigration row
#oa	#oa (please read the tweets to get the meaning)
#access	#access
#research	#research
#lucaya	#lucaya
#thankssanta	#thanks santa
#jenosmrookiesopenfolback	#jenosmrookiesopenfolback
#preprints	#preprints
#open	#open
#cmaopenaccess	#cma (CMA: a qualification certificate) openaccess
#openeducation	#open education
#opendata	#open data
#rickypo	#rickypo
#openscience	#open science
#writing	#writing
#amwriting	#am writing
#writingquote	#writing quote
#writingtips	#writing tips
#fictionwriting	#fiction writing
#writertips	#writer tips
#creativewriting	#creative writing
#writinginspiration	#writing inspiration
#imaginedragonsnomultishow	#imagine dragons no multi show
#writingcommnunity	#writing commnunity
#snails	#snails
#writingchat	#writing chat
#writingtip	#writing tip
#freegiveaway	#free give away
#writingadvice	#writing advice
#essaywriting	#essay writing
#content	#content
#stopportrayingasimnegative	#stop portraying Asim negative
#asimforthewin	#Asim for the win
#stoptargetingabijeet	#stop targeting abijeet
#asimriaz	#asimriaz
#favmw	#favour museum week
#negative	#negative
#asim	#Asim
#blackpinkforamas	#Blackpink for amas
#biasedbbtargetsasim	#biased bb(BB: bigg boss, Indian TV show) targets asim
#colour	#colour
#vanoe48sayangsinkajuliani	#vanoe48sayangsinkajuliani
#doublenegative	#double negative
#evo2015	#evo2015
#asimsquad	#Asim squad
#asimdebut	#Asim debut(debut: first show)
#stoptargetingasim	#stop targeting Asim
#beingsalmankhan	#being salmankhan
#negativegearing	#negative gearing
#ps4live	#ps4live (ps: playstation, game console)
#live	#live
#supportsmallstreamers	#support small streamers(streamers: a person who broadcast themselves online)
#ps4nodrm	#ps4 no drm (Digital Rights Management; pay before play the game)
#ps5share	#ps5 share
#frogstv	#frogstv
#livepdnation	#live pd nation
#twitchstream	#twitch (American video live streaming service APP) stream
#rvawx	#rvawx
#pubgxboxone	#pubg (PlayerUnknown's Battlegrounds; a shotting game) xbox one (game console)
#workparty	#workparty (an online podcast)
#twitch	#twitch (American video live streaming service APP)
#ps4	#Playstation4, game console
#cam4live	#cam4live
#lurxquad	#lurxquad
#happyvday2015	#happy vday 2015
#kukululive	#kukululive
#mysmatv	#mysmatv
#nohateinmystate	#no hate in my state
#lgbt	#lesbian, gay, bisexual, and transgender
#loveisinmyblood	#love is in my blood
#ihavenolovefor	#i have no love for
#ihatethefactthat	#i hate the fact that
#sportsinjuries	#sports injuries
#hb757	#hb757
#endtheveto	#end the veto(veto: an official power or right to refuse to accept or allow something)
#loveconquershate	#love conquers hate
#repealhb2	#repeal (revoke) hb2 (HB2: a law that anti-LGBT)
#stophomophobia	#stop homophobia(homophobia: dislike of or prejudice against gay people.)
#hb2	#hb2 (HB2: a law that anti-LGBT)
#ohreally	#oh really
#no2lgbthate	#no to lesbian, gay, bisexual, and transgender hate
#lgbtequality	#lesbian, gay, bisexual, and transgender equality
#doitforstate	#do it for state
#noshameinmygame	#no shame in my game
#bapusuratsingh	#bapusuratsingh
#watchthis	#watch this
#subcribe	#subcribe
#omg	#omg (oh my god)
#lasvegasmassacre	#Las Vegas massacre (massacre:kill lots of people)
#mattsvideooftheweek	#matts video of the week
#gowatch	#go watch
#nn13	#nn13
#gowatchit	#go watch it
#rt	#retweet
#this	#this
#watchit	#watch it
#blacksaturday	#black saturday
#watchthisspace	#watch this space
#watchrickysnewvideo	#watch rickys new video
#doggie	#doggie
#justwatch	#just watch
#camsnewvideo	#cams new video
#presidentberniesanders	#president Bernie Sanders
#berniewon	#Bernie Sanders won
#berniesanders	#Bernie Sanders
#motion	#motion
#berniesandersforpresident2016	#Bernie Sanders for president 2016
#berniesanders2020	#Bernie Sanders 2020
#backstabbers	#back stabbers (stab someone from the back; betray)
#donaldtrumpforpresident	#Donald Trump for president
#wxtweeter	#wxtweeter
#ilovepizza	#i love pizza
#lovemeright6thwin	#love me right 6th win
#bernie2020	#Bernie Sanders 2020
#presidentwarren	#president Warren (29th president of the United States)
#berniebeatstrump	#Bernie Sanders beats Donald Trump
#presidentbarackobama	#President Barack Obama
#presidentsanders	#President Bernie Sanders
#mustafi	#mustafi
#holiday	#holiday
#holidaysarecoming	#holidays are coming
#handmadeholiday	#hand made holiday
#familyholidays	#family holidays
#mpointsholiday	#mpoints holiday
#holidaydeals	#holiday deals
#kkwholiday	#kkw holiday
#threadripper	#threadripper (AMD CPU)
#christmas	#christmas
#holidaytshirt	#holiday T-shirt
#fpholidaymoments	#fp holiday moments
#travel	#travel
#vacation	#vacation
#summerholiday	#summer holiday
#holidayweekend	#holiday weekend
#happyholiday	#happy holiday
#puyallup	#puyallup (city in Pierce County, Washington, United States)
#choicebreakouttvshow	#choice breakout TVshow
#landsendholiday	#landsend holiday
#faith	#faith
#biblesurprise	#bible surprise
#trustinhim	#trust in him
#shutters	#shutters
#nautica	#nautica
#trustingod	#trustin god
#sehunyehet	#sehunyehet
#bible	#bible
#hope	#hope
#experiencinggod	#experiencing god
#healthyfaith	#healthy faith
#prayer	#prayer
#love	#love
#qfaith	#qfaith
#keepingfaith	#keeping faith
#unshakablefaith	#unshakable faith
#faithtalk	#faith talk
#keepfaith	#keep faith
#companies	#companies
#ukblackownedbusinesses	#ukblackownedbusinesses
#consumergoods	#consumergoods
#firms	#firms
#truckingcompanies	#truckingcompanies
#survivorallstar	#survivorallstar
#jobsinstartups	#jobsinstartups
#yostartups	#yostartups
#kidscantwait	#kidscantwait
#valenciagp	#valenciagp
#pharmaceutical	#pharmaceutical
#businesses	#businesses
#businessnews	#businessnews
#technology	#technology
#ceos	#ceos
#sellingsocially	#sellingsocially
#fmcg	#fmcg
#blacksupremacy	#blacksupremacy
#festivus	#festivus
#blacked	#blacked
#blackbred	#blackbred
#babycousin	#babycousin
#breedblack	#breedblack
#blackisbetter	#blackisbetter
#blackpowerisforblackmen	#blackpowerisforblackmen
#blackonly	#blackonly
#supremacy	#supremacy
#saynotowhiteboys	#saynotowhiteboys
#femalesupremacy	#femalesupremacy
#bnwo	#bnwo
#black505	#black505
#black	#black
#heroileague	#heroileague
#whitesupremacy	#whitesupremacy
#sidereel	#sidereel
#reel	#reel
#reeltalk	#reeltalk
#catfish	#catfish
#showgoers	#showgoers
#dragonballchou	#dragonballchou
#gin	#gin
#tvtime	#tvtime
#iraniansdetestsoleimani	#iraniansdetestsoleimani
#highlightreel	#highlightreel
#taylurking	#taylurking
#blackgirlsbreaktheinternet	#blackgirlsbreaktheinternet
#digitallearning	#digitallearning
#beamly	#beamly
#showreel	#showreel
#icheckmovies	#icheckmovies
#seenitapp	#seenitapp
#letthegoodtimesroll	#letthegoodtimesroll
#thegooddays	#thegooddays
#theyseemerollin	#theyseemerollin
#herestothegoodtimes	#herestothegoodtimes
#getwiththetimes	#getwiththetimes
#thankful	#thankful
#rollontheweekend	#rollontheweekend
#food	#food
#gonnabefun	#gonnabefun
#mayday2020	#mayday2020
#thisishowweroll	#thisishowweroll
#springbreak	#springbreak
#thetimes	#thetimes
#letitbegin	#letitbegin
#dayofdays	#dayofdays
#goodtimesahead	#goodtimesahead
#michiganprimary	#michiganprimary
#greatvibesandenergy	#greatvibesandenergy
#newfollowers	#newfollowers
#followsback	#followsback
#followback	#followback
#morefollowers	#morefollowers
#welcometweet	#welcometweet
#new	#new
#wantmorefollowers	#wantmorefollowers
#otwolimsorry	#otwolimsorry
#someonetellcnn	#someonetellcnn
#teamfollowback	#teamfollowback
#nowfollowingback	#nowfollowingback
#copyfollowers	#copyfollowers
#weighin	#weighin
#follow	#follow
#newfollower	#newfollower
#topnewfollowers	#topnewfollowers
#patreon	#patreon
#crowdfunding	#crowdfunding
#binxcoins	#binxcoins
#wylaradio	#wylaradio
#ufcmoscow	#ufcmoscow
#t4a	#t4a
#cyberpinoyradio	#cyberpinoyradio
#podcast	#podcast
#webcomic	#webcomic
#patterson	#patterson
#paternity	#paternity
#onpatreon	#onpatreon
#candiscover	#candiscover
#signage	#signage
#indiecomics	#indiecomics
#warlords	#warlords
#influenza	#influenza
#flu	#flu
#virusnext	#virusnext
#h7n9	#h7n9
#fluvax	#fluvax
#avian	#avian
#silliness	#silliness
#safari7s	#safari7s
#h5n1	#h5n1
#grid2	#grid2
#influenceconf	#influenceconf
#avianflu	#avianflu
#influentialerica	#influentialerica
#swineflu	#swineflu
#health	#health
#vaccine	#vaccine
#affluenza	#affluenza
#titanium	#titanium
#cheyfortaylor	#cheyfortaylor
#davidguetta	#davidguetta
#steel	#steel
#stainless	#stainless
#exoluxioninnewyork	#exoluxioninnewyork
#titwank	#titwank
#diamante	#diamante
#alloy	#alloy
#sia	#sia
#myterratech	#myterratech
#bigtitsmafia	#bigtitsmafia
#ebayguitar	#ebayguitar
#beatitudes	#beatitudes
#aluminium	#aluminium
#eurovision	#eurovision
#weldoftheday	#weldoftheday
#pilliga	#pilliga
#muscle	#muscle
#musclebuilding	#musclebuilding
#euphoriafinale	#euphoriafinale
#musclegay	#musclegay
#musclemonday	#musclemonday
#nal	#nal
#fitness	#fitness
#gym	#gym
#gaymuscle	#gaymuscle
#fitnessampworkout	#fitnessampworkout
#muscleshoals	#muscleshoals
#mexicovsusa	#mexicovsusa
#bodybuilding	#bodybuilding
#buildmuscle	#buildmuscle
#humorous	#humorous
#funnyjpegs	#funnyjpegs
#humor	#humor
#usa2day	#usa2day
#parodyts	#parodyts
#amusing	#amusing
#kashmirsolidarityday	#kashmirsolidarityday
#humorousfeed	#humorousfeed
#bigblackcocks	#bigblackcocks
#danielboone	#danielboone
#chuckle	#chuckle
#comical	#comical
#mirth	#mirth
#funniness	#funniness
#taughtherwell	#taughtherwell
#letsgogirls	#letsgogirls
#tswiftonthevoice	#tswiftonthevoice
#mobicard	#mobicard
#thepregame	#thepregame
#win	#win
#letsgocrazy	#letsgocrazy
#letsgoboys	#letsgoboys
#letsgoback	#letsgoback
#lesgo	#lesgo
#leggooo	#leggooo
#itsgotime	#itsgotime
#minutetowinit	#minutetowinit
#nced	#nced
#cubs	#cubs
#letsgopreds	#letsgopreds
#legggo	#legggo
#youngpreacher	#youngpreacher
#letstalk	#letstalk
#depressionawarenessweek	#depressionawarenessweek
#mentalhealthmatters	#mentalhealthmatters
#bellletstalkday	#bellletstalkday
#letstalkresps	#letstalkresps
#worldhealthday	#worldhealthday
#fme	#fme
#wooletstalk	#wooletstalk
#depression	#depression
#mentalhealth	#mentalhealth
#letstalkdance	#letstalkdance
#bellletstalk	#bellletstalk
#beiiletstalk	#beiiletstalk
#timetotalkday	#timetotalkday
#mentalhealthawarenessweek	#mentalhealthawarenessweek
#macysbelieve	#macysbelieve
#pint16	#pint16
#letstalklove	#letstalklove
#standwithiraqirefugees	#standwithiraqirefugees
#turkey	#turkey
#punjabstandswithcmkhattak	#punjabstandswithcmkhattak
#standwitharmy	#standwitharmy
#withrefugees	#withrefugees
#urawareds	#urawareds
#turkeyinvadeskurdistan	#turkeyinvadeskurdistan
#supportkashmirirefugees	#supportkashmirirefugees
#serpent	#serpent
#standwithkashmir	#standwithkashmir
#iraqi	#iraqi
#matchdaylive	#matchdaylive
#saverohingyamuslims	#saverohingyamuslims
#iranianrefugeesinturkey	#iranianrefugeesinturkey
#nosyrianrefugees	#nosyrianrefugees
#refugees	#refugees
#asap	#asap
#proteafire	#proteafire
#asapkapameilyalizquen	#asapkapameilyalizquen
#asapunite	#asapunite
#soreadyfordigifest	#soreadyfordigifest
#asapconnect	#asapconnect
#kathnielasapliveinla	#kathnielasapliveinla
#needsmust	#needsmust
#it	#it
#asapgoals	#asapgoals
#naturalresources	#naturalresources
#smp	#smp
#likenow	#likenow
#asapnovembest	#asapnovembest
#needmyfix	#needmyfix
#dtn	#dtn
#pronto	#pronto
#help	#help
#shegod	#shegod
#looksgood	#looksgood
#dominatrix	#dominatrix
#shepower	#shepower
#barbiedoll	#barbiedoll
#femocracy	#femocracy
#compensation	#compensation
#femdom	#femdom
#newscene	#newscene
#martinsheen	#martinsheen
#chriscuomo	#chriscuomo
#sheila	#sheila
#kcvsoak	#kcvsoak
#shelies	#shelies
#icselcaday	#icselcaday
#shether	#shether
#loneliness	#loneliness
#boredom	#boredom
#lalunasangrenewprophecy	#lalunasangrenewprophecy
#grape	#grape
#konnectinspirationalwednesday	#konnectinspirationalwednesday
#isolation	#isolation
#bisex	#bisex
#despair	#despair
#socialisolation	#socialisolation
#abbottlovesanal	#abbottlovesanal
#endloneliness	#endloneliness
#ghosts	#ghosts
#ghostadventureslive	#ghostadventureslive
#ghosthunters	#ghosthunters
#xboxghosts	#xboxghosts
#kidsseeghosts	#kidsseeghosts
#aldubnevergiveup	#aldubnevergiveup
#madmenfinale	#madmenfinale
#ahauntedhouse	#ahauntedhouse
#ghoststories	#ghoststories
#haunted	#haunted
#horror	#horror
#paranormal	#paranormal
#bbcghosts	#bbcghosts
#dreamhomes	#dreamhomes
#twoghosts	#twoghosts
#ghosthunting	#ghosthunting
#ghouls	#ghouls
#nike	#nike
#avant	#avant
#nikexnba	#nikexnba
#tpir	#tpir
#boycottnike	#boycottnike
#lapaknikeshoes	#lapaknikeshoes
#ebaynike	#ebaynike
#shoes	#shoes
#iambuddha	#iambuddha
#nikeshoes	#nikeshoes
#nikebasketball	#nikebasketball
#reebok	#reebok
#athleticsneakers	#athleticsneakers
#retro	#retro
#shopkix	#shopkix
#ebayadidas	#ebayadidas
#best	#best
#bendtheknee	#bendtheknee
#inbend	#inbend
#takeastandnotaknee	#takeastandnotaknee
#taketheknee	#taketheknee
#bendtherules	#bendtherules
#mentionagoodcouple	#mentionagoodcouple
#bend	#bend
#takeaknee	#takeaknee
#knee	#knee
#gameofthrones	#gameofthrones
#voteyouneedtocalmdown	#voteyouneedtocalmdown
#hemi	#hemi
#kneel	#kneel
#rsna16	#rsna16
#foodwaste	#foodwaste
#jersey	#jersey
#sustainablefood	#sustainablefood
#employeeappreciation	#employeeappreciation
#koreanews	#koreanews
#wastemanagement	#wastemanagement
#notwasting	#notwasting
#plasticwaste	#plasticwaste
#tickle	#tickle
#zerowaste	#zerowaste
#free	#free
#waronwaste	#waronwaste
#unitedkingdom	#unitedkingdom
#waste	#waste
#foodfoodfood	#foodfoodfood
#helthyfood	#helthyfood
#lovefoodhatewaste	#lovefoodhatewaste
#makeyourownlane	#makeyourownlane
#stayurownlane	#stayurownlane
#lovelyday	#lovelyday
#makeyourown	#makeyourown
#mpgvip	#mpgvip
#myownlane	#myownlane
#goyourownway	#goyourownway
#entrepreneur	#entrepreneur
#defstar5	#defstar5
#successtrain	#successtrain
#freshmanprobs	#freshmanprobs
#niggawemadeit	#niggawemadeit
#gnite	#gnite
#hayesdwts	#hayesdwts
#gnar	#gnar
#gnation	#gnation
#ite	#ite
#goodnite	#goodnite
#imsosickof	#imsosickof
#muchlove	#muchlove
#day6	#day6
#starfish	#starfish
#offline4sleep	#offline4sleep
#goodnightyall	#goodnightyall
#nightworld	#nightworld
#navi	#navi
#bealrighttonight	#bealrighttonight
#nightynight	#nightynight
#summerproblems	#summerproblems
#andhadhun	#andhadhun
#lovemyjob	#lovemyjob
#graphicdesign	#graphicdesign
#logodesigner	#logodesigner
#logodesign	#logodesign
#adobeillustrator	#adobeillustrator
#tid	#tid
#graphicdesigner	#graphicdesigner
#bannerdesign	#bannerdesign
#illustration	#illustration
#graphicdesigners	#graphicdesigners
#indiaistolerant	#indiaistolerant
#graphicdesigngig	#graphicdesigngig
#art	#art
#remoaner	#remoaner
#graphic	#graphic
#design	#design
#graphicart	#graphicart
#mygarden	#mygarden
#gardenlife	#gardenlife
#irises	#irises
#loveyourgarden	#loveyourgarden
#myaskmeselfie	#myaskmeselfie
#garden	#garden
#flowerreport	#flowerreport
#flowers	#flowers
#wildflowers	#wildflowers
#arsenalquiz	#arsenalquiz
#mymymy	#mymymy
#nkpeace	#nkpeace
#gardening	#gardening
#flowering	#flowering
#parkbogum	#parkbogum
#shrubs	#shrubs
#redlines	#redlines
#cop21	#cop21
#redline	#redline
#pht1	#pht1
#syria	#syria
#lines	#lines
#blacklines	#blacklines
#jedwardrockstar	#jedwardrockstar
#assad	#assad
#ualr	#ualr
#redlegs	#redlegs
#faultlines	#faultlines
#pht	#pht
#tamvancrew	#tamvancrew
#linkjkt48	#linkjkt48
#miamigardens	#miamigardens
#pht16	#pht16
#australianfires	#australianfires
#australianbushfires	#australianbushfires
#australiabushfires	#australiabushfires
#iloveshinee	#iloveshinee
#australiafires	#australiafires
#sunrise3fm	#sunrise3fm
#australiancoins	#australiancoins
#seadogs	#seadogs
#australiaburning	#australiaburning
#australianbushfire	#australianbushfire
#australianstory	#australianstory
#australianagenda	#australianagenda
#framing	#framing
#bushfirecrisis	#bushfirecrisis
#shenandoah	#shenandoah
#australia	#australia
#goroar	#goroar
#auspol	#auspol
#skydiving	#skydiving
#retweet	#retweet
#diving	#diving
#skydome	#skydome
#redbullcliffdiving	#redbullcliffdiving
#skydive	#skydive
#redcliffe	#redcliffe
#skyscrapperlive	#skyscrapperlive
#skyboxing	#skyboxing
#paragliding	#paragliding
#mivoto40auryn	#mivoto40auryn
#aerobatics	#aerobatics
#adrenalinejunkie	#adrenalinejunkie
#gliding	#gliding
#assoftheday	#assoftheday
#patriots	#patriots
#pats	#pats
#nfl	#nfl
#patriotsunited	#patriotsunited
#superbowl	#superbowl
#patriotsday	#patriotsday
#newenglandpatriots	#newenglandpatriots
#sisterpatriots	#sisterpatriots
#broncos	#broncos
#patriotsunite	#patriotsunite
#amazonprimevideo	#amazonprimevideo
#timyrealdeal	#timyrealdeal
#duckprints	#duckprints
#gopatriots	#gopatriots
#nepatriots	#nepatriots
#teampatriots	#teampatriots
#abuseofpower	#abuseofpower
#cultureofcorruption	#cultureofcorruption
#trumpisanabuser	#trumpisanabuser
#obstructionofjustice	#obstructionofjustice
#criminalinchief	#criminalinchief
#powerof10	#powerof10
#orthopedics	#orthopedics
#irs	#irs
#powerofwomen	#powerofwomen
#americanmasters	#americanmasters
#powerofpositivity	#powerofpositivity
#poweroffrozen	#poweroffrozen
#corruptgop	#corruptgop
#thepoweroflove	#thepoweroflove
#exodustostarmovies	#exodustostarmovies
#corruption	#corruption
#gopcorruption	#gopcorruption
#top	#top
#toprated	#toprated
#yeezy	#yeezy
#top10	#top10
#top50	#top50
#top20	#top20
#gilt	#gilt
#top6	#top6
#videostodownload	#videostodownload
#thebestmusic	#thebestmusic
#news	#news
#top40	#top40
#tops	#tops
#food4thought	#food4thought
#shirtstops	#shirtstops
#showyonerve	#showyonerve
#top14	#top14
#wfh	#wfh
#workingfromhome	#workingfromhome
#remotejob	#remotejob
#myblackisbeautiful	#myblackisbeautiful
#cwfh	#cwfh
#remotejobs	#remotejobs
#homeworking	#homeworking
#shesavvy	#shesavvy
#workathome	#workathome
#digpink	#digpink
#youaremysunshine	#youaremysunshine
#fh	#fh
#chronam	#chronam
#remotework	#remotework
#madisonville	#madisonville
#homebusiness	#homebusiness
#hfh	#hfh
#checkout	#checkout
#checkeditout	#checkeditout
#dispromo	#dispromo
#newmusic	#newmusic
#favglobalmusicbts	#favglobalmusicbts
#kibra	#kibra
#poorform	#poorform
#browse	#browse
#clickthelink	#clickthelink
#supermarket	#supermarket
#nervedjsmixtapes	#nervedjsmixtapes
#ciochat	#ciochat
#support	#support
#grocery	#grocery
#cashier	#cashier
#flipkartcoupons	#flipkartcoupons
#renaissancepodcast	#renaissancepodcast
#drwho	#drwho
#tardis	#tardis
#bsbdayfollowspree	#bsbdayfollowspree
#drwow	#drwow
#doctoradventures	#doctoradventures
#socialweb	#socialweb
#doctorwhoxmas	#doctorwhoxmas
#nri	#nri
#readingtime	#readingtime
#drdo	#drdo
#doctorwho50thanniversary	#doctorwho50thanniversary
#whyilovepak	#whyilovepak
#clapper	#clapper
#drking	#drking
#dalek	#dalek
#doctorwho	#doctorwho
#doctorwhoontwitch	#doctorwhoontwitch
#doctorwho13	#doctorwho13
#fab	#fab
#stayfab	#stayfab
#fabfriday	#fabfriday
#wordedtuesday	#wordedtuesday
#sexyart	#sexyart
#fab4	#fab4
#babeoftheweek	#babeoftheweek
#msglionheart	#msglionheart
#fabindia	#fabindia
#fabfour	#fabfour
#absolutelyfabulous	#absolutelyfabulous
#etsystar	#etsystar
#automatictrading	#automatictrading
#amazing	#amazing
#fab50	#fab50
#fab5	#fab5
#breaking	#breaking
#ufc	#ufc
#bigbreaking	#bigbreaking
#mfanews	#mfanews
#breaking411	#breaking411
#justthenews	#justthenews
#feb28coup	#feb28coup
#breaking2	#breaking2
#breakingnew	#breakingnew
#mitvlagos	#mitvlagos
#saharareporters	#saharareporters
#tribeca	#tribeca
#antifa	#antifa
#breakingnews	#breakingnews
#breakingpoll	#breakingpoll
#detroitlions	#detroitlions
#breakingbad	#breakingbad
#breaking144	#breaking144
#password	#password
#encrypt	#encrypt
#drakebellspassword	#drakebellspassword
#hiking	#hiking
#expertspywareremoval	#expertspywareremoval
#security	#security
#passwords	#passwords
#justinspasswordattempts	#justinspasswordattempts
#artistsofsea	#artistsofsea
#passwordday	#passwordday
#hacked	#hacked
#stepdaughter	#stepdaughter
#cybersecurity	#cybersecurity
#nakedsecurity	#nakedsecurity
#rewardspoints	#rewardspoints
#findyourroute	#findyourroute
#rewards	#rewards
#membersgetlt	#membersgetlt
#atlassian	#atlassian
#mrpoints	#mrpoints
#starbucksrewards	#starbucksrewards
#magcultmemories	#magcultmemories
#betterpoints	#betterpoints
#jee	#jee
#membersgetit	#membersgetit
#points	#points
#bonuspoints	#bonuspoints
#world	#world
#worldwizkidday	#worldwizkidday
#worldsmileday	#worldsmileday
#veranomtv2017	#veranomtv2017
#iran	#iran
#beautifulworld	#beautifulworld
#farsnews	#farsnews
#worldmusic	#worldmusic
#socialtimes	#socialtimes
#worldparkinsonsday	#worldparkinsonsday
#unami	#unami
#euronews	#euronews
#prayforturkey	#prayforturkey
#matraffic	#matraffic
#irannews	#irannews
#amazingworld	#amazingworld
#newsworld	#newsworld
#usa	#usa
#bluetooth	#bluetooth
#britishmasters	#britishmasters
#cellphonesandaccessories	#cellphonesandaccessories
#earbud	#earbud
#headphone	#headphone
#wifi	#wifi
#wireless	#wireless
#blueprints	#blueprints
#blueballs	#blueballs
#studiosession	#studiosession
#rydercup18	#rydercup18
#popular	#popular
#speakers	#speakers
#headset	#headset
#bluetoothspeaker	#bluetoothspeaker
#shaving	#shaving
#wetshaving	#wetshaving
#tribeopener	#tribeopener
#shaved	#shaved
#enneagram	#enneagram
#razors	#razors
#shavedpussy	#shavedpussy
#regd	#regd
#gillette	#gillette
#mensgrooming	#mensgrooming
#shave	#shave
#schick	#schick
#becounted	#becounted
#myvotecounts	#myvotecounts
#votejujufranco	#votejujufranco
#junephotochallenge	#junephotochallenge
#census2020	#census2020
#yourvotematters	#yourvotematters
#berespectful	#berespectful
#beremarkable	#beremarkable
#betruthful	#betruthful
#hotspur	#hotspur
#be3	#be3
#votethankunext	#votethankunext
#census	#census
#be	#be
#beboldendhyde	#beboldendhyde
#everyvotecounts	#everyvotecounts
#voteoutloud	#voteoutloud
#childrenincages	#childrenincages
#vote	#vote
#coolfacts	#coolfacts
#facts	#facts
#cbdlife	#cbdlife
#crazyfacts	#crazyfacts
#scians	#scians
#anavsnsh	#anavsnsh
#uberfacts	#uberfacts
#whattheffacts	#whattheffacts
#justfacts	#justfacts
#tukuza	#tukuza
#amazingfacts	#amazingfacts
#factsarefacts	#factsarefacts
#cbdinfo	#cbdinfo
#funfacts	#funfacts
#alcalfunfacts	#alcalfunfacts
#howcool	#howcool
#omgfacts	#omgfacts
#uselessfacts	#uselessfacts
#bushfires	#bushfires
#teamflash	#teamflash
#teamsilva	#teamsilva
#walkawaycampaign	#walkawaycampaign
#nswfires	#nswfires
#crisis	#crisis
#opiodcrisis	#opiodcrisis
#stopthefires	#stopthefires
#vicfires	#vicfires
#bushfire	#bushfire
#anyway	#anyway
#votethomasmtv	#votethomasmtv
#anyways	#anyways
#doitanyway	#doitanyway
#else	#else
#radio	#radio
#whoselineisitanyway	#whoselineisitanyway
#itswhatever	#itswhatever
#bibitattogamer	#bibitattogamer
#callmetez	#callmetez
#hideyakids	#hideyakids
#nsb	#nsb
#martinamcbride	#martinamcbride
#econcernme	#econcernme
#nobodybutyou	#nobodybutyou
#djcarisma	#djcarisma
#whateva	#whateva
#though	#though
#tbh	#tbh
#buymalibuonitunes	#buymalibuonitunes
#southasia	#southasia
#liveonearthla	#liveonearthla
#imissyoutoo	#imissyoutoo
#oomf	#oomf
#tbf	#tbf
#woodyfromhomexmewgulf	#woodyfromhomexmewgulf
#getoutofmylife	#getoutofmylife
#heatpump	#heatpump
#honestlyhour	#honestlyhour
#dab	#dab
#me	#me
#missyoulikecrazy	#missyoulikecrazy
#sincewebeinghonest	#sincewebeinghonest
#tbhfanproblems	#tbhfanproblems
#jisung	#jisung
#confessionight	#confessionight
#tbh5	#tbh5
#idontlikeyou	#idontlikeyou
#idontknowyou	#idontknowyou
#sctweets	#sctweets
#leavemealone	#leavemealone
#goaway	#goaway
#magenta	#magenta
#cantstandyou	#cantstandyou
#thingsidontlike	#thingsidontlike
#sorrynotsorry	#sorrynotsorry
#dontlikeyou	#dontlikeyou
#besttimes	#besttimes
#icantbeurfriendbecause	#icantbeurfriendbecause
#ilikeyou	#ilikeyou
#idontlike	#idontlike
#catsoftwitter	#catsoftwitter
#catlovers	#catlovers
#mytherapy	#mytherapy
#flatdesign	#flatdesign
#cutecats	#cutecats
#cats	#cats
#caturday	#caturday
#catsontwitter	#catsontwitter
#naughtygirloftwitter	#naughtygirloftwitter
#girlsoftwitter	#girlsoftwitter
#slowlybutsurely	#slowlybutsurely
#catsrule	#catsrule
#rescuecat	#rescuecat
#dogsoftwitter	#dogsoftwitter
#adoptdontshop	#adoptdontshop
#bouncy	#bouncy
#hitbanger	#hitbanger
#twitterblueroom	#twitterblueroom
#softplay	#softplay
#jazzy	#jazzy
#thehappymonster	#thehappymonster
#catchy	#catchy
#aceofspace	#aceofspace
#fun	#fun
#playroom	#playroom
#wrestlemania29	#wrestlemania29
#crappyhalloweencostumes	#crappyhalloweencostumes
#impeachunpotus	#impeachunpotus
#twittermirror	#twittermirror
#ipartychat	#ipartychat
#funky	#funky
#bouncycastle	#bouncycastle
#onlocation	#onlocation
#forcedlabor	#forcedlabor
#growingupahoe	#growingupahoe
#forcedlabour	#forcedlabour
#slavelabor	#slavelabor
#labor	#labor
#trafficking	#trafficking
#bdaybash	#bdaybash
#worlddayagainstchildlabour	#worlddayagainstchildlabour
#humantrafficking	#humantrafficking
#uzbekistan	#uzbekistan
#modernslavery	#modernslavery
#kensington	#kensington
#childlabor	#childlabor
#laborday2016	#laborday2016
#military	#military
#godblessourmilitary	#godblessourmilitary
#militaryfamily	#militaryfamily
#staystrongforows	#staystrongforows
#militaryromance	#militaryromance
#militaryhistory	#militaryhistory
#vln	#vln
#militarylife	#militarylife
#yesonprop1	#yesonprop1
#pjnet	#pjnet
#militaryfamilies	#militaryfamilies
#veterans	#veterans
#ustroops	#ustroops
#troops	#troops
#usmilitary	#usmilitary
#saluteourforces	#saluteourforces
#armedforcesflagday	#armedforcesflagday
#army	#army
#understanding	#understanding
#empaths	#empaths
#bitterness	#bitterness
#lovingkindness	#lovingkindness
#bekindalways	#bekindalways
#loveothers	#loveothers
#soflo	#soflo
#knowledgesharing	#knowledgesharing
#peace	#peace
#understood	#understood
#cpl	#cpl
#canthardlywait	#canthardlywait
#misunderstanding	#misunderstanding
#understand	#understand
#theknowledge	#theknowledge
#knowledge	#knowledge
#kingforaday	#kingforaday
#hailtotheking	#hailtotheking
#asapotwolday	#asapotwolday
#gratata	#gratata
#tucker	#tucker
#pidis	#pidis
#ificouldfly	#ificouldfly
#itsagreatdayfor	#itsagreatdayfor
#piercetheveil	#piercetheveil
#ptv	#ptv
#smilemoreforagoodday	#smilemoreforagoodday
#haveaday	#haveaday
#rrvkxip	#rrvkxip
#onefineday	#onefineday
#kingsday	#kingsday
#tristanevansisking	#tristanevansisking
#onceselcaday	#onceselcaday
#longlivetheking	#longlivetheking
#makemoneyonline	#makemoneyonline
#makemoney	#makemoney
#earnfromhome	#earnfromhome
#candle4ssr	#candle4ssr
#earnmoneyonline	#earnmoneyonline
#earnmoney	#earnmoney
#makemoneyfromhome	#makemoneyfromhome
#moneyonline	#moneyonline
#onlineincome	#onlineincome
#poppintags	#poppintags
#shag	#shag
#affiliatemarketing	#affiliatemarketing
#workfromhome	#workfromhome
#makingmoneyonline	#makingmoneyonline
#donald	#donald
#thingstrumpthinksareoverrated	#thingstrumpthinksareoverrated
#trump2016	#trump2016
#trump2020	#trump2020
#ssu22	#ssu22
#trumps	#trumps
#racistdrumpf	#racistdrumpf
#trumpisatraitor	#trumpisatraitor
#trumppresident	#trumppresident
#gop	#gop
#terribletrump	#terribletrump
#whyidontliketrump	#whyidontliketrump
#trump2024	#trump2024
#grandjunction	#grandjunction
#txstate	#txstate
#presidenttrump	#presidenttrump
#livetoday	#livetoday
#tuneintojoyfm	#tuneintojoyfm
#livefornow	#livefornow
#quotestoliveby	#quotestoliveby
#nowlive	#nowlive
#thebigbang	#thebigbang
#life	#life
#mediapromo	#mediapromo
#liveherelivewell	#liveherelivewell
#coldspring	#coldspring
#livelifeloud	#livelifeloud
#azsen	#azsen
#livefortoday	#livefortoday
#quotes	#quotes
#tuneinandenjoy	#tuneinandenjoy
#xiaomi	#xiaomi
#australianvalues	#australianvalues
#yangxiaolong	#yangxiaolong
#android	#android
#acon	#acon
#androidone	#androidone
#redmi	#redmi
#meizu	#meizu
#xiaoven	#xiaoven
#mia2	#mia2
#celly	#celly
#slflmanchester1	#slflmanchester1
#britishgas	#britishgas
#androidm	#androidm
#tech	#tech
#axiom	#axiom
#google	#google
#jiophone	#jiophone
#smartwater	#smartwater
#thehindu	#thehindu
#hayonwye	#hayonwye
#mcfridaytreat	#mcfridaytreat
#boynevalley	#boynevalley
#bimabhaskaramisswenwenhan	#bimabhaskaramisswenwenhan
#hindu	#hindu
#thehoff	#thehoff
#b1less	#b1less
#vandyemataram	#vandyemataram
#regionalindian	#regionalindian
#indianexpress	#indianexpress
#whataretheodds	#whataretheodds
#nationalherald	#nationalherald
#india	#india
#hinduterrorism	#hinduterrorism
#indiatoday	#indiatoday
#national	#national
#capture	#capture
#askingforafriend	#askingforafriend
#inquiringmindswanttoknow	#inquiringmindswanttoknow
#thankyouforbeingafriend	#thankyouforbeingafriend
#suriyabirthdayfestcdp	#suriyabirthdayfestcdp
#askcamdatingadvice	#askcamdatingadvice
#winteriscoming	#winteriscoming
#madcap	#madcap
#holdmybeer	#holdmybeer
#askforafollowback	#askforafollowback
#beafriend	#beafriend
#justaskin	#justaskin
#howtoasksomeoneonadate	#howtoasksomeoneonadate
#whatarefriendsfor	#whatarefriendsfor
#vote2020	#vote2020
#emjvideo	#emjvideo
#askingforit	#askingforit
#needafriend	#needafriend
#askingformyself	#askingformyself
#ps5	#ps5
#seniorliving	#seniorliving
#fohlenelf	#fohlenelf
#ratchetps5	#ratchetps5
#ps3	#ps3
#playstation5	#playstation5
#ps5reveal	#ps5reveal
#stylus	#stylus
#rodeo	#rodeo
#ps63	#ps63
#ps2	#ps2
#xboxseriesx	#xboxseriesx
#actonclimate	#actonclimate
#spb	#spb
#backclimateaction	#backclimateaction
#climate	#climate
#priceoncarbon	#priceoncarbon
#climateaction	#climateaction
#act	#act
#defendclimate	#defendclimate
#climateactionnow	#climateactionnow
#frozenonstarmovies	#frozenonstarmovies
#keepitintheground	#keepitintheground
#climatechange	#climatechange
#rosesarerosieday	#rosesarerosieday
#forwardonclimate	#forwardonclimate
#peoplesclimate	#peoplesclimate
#climatechangeisreal	#climatechangeisreal
#leadonclimate	#leadonclimate
#facerecognition	#facerecognition
#facetimemenash	#facetimemenash
#machinevision	#machinevision
#ai	#ai
#face	#face
#stopbrexitnow	#stopbrexitnow
#smartglasses	#smartglasses
#facereveal	#facereveal
#recognition	#recognition
#bigdata	#bigdata
#faceface	#faceface
#facialrecognition	#facialrecognition
#thingsbetterthanukfootball	#thingsbetterthanukfootball
#mybmore	#mybmore
#faceid	#faceid
#truth	#truth
#theuglytruth	#theuglytruth
#honesttruth	#honesttruth
#fuchsia	#fuchsia
#realtalk	#realtalk
#nakedtruth	#nakedtruth
#universaltruth	#universaltruth
#minions	#minions
#selfworth	#selfworth
#teambap	#teambap
#beauthentic	#beauthentic
#loveyourtruth	#loveyourtruth
#freedom	#freedom
#stereotypes	#stereotypes
#reporttruth	#reporttruth
#thetruth	#thetruth
#truthis	#truthis
#realtruth	#realtruth
#sos	#sos
#manus	#manus
#milsos	#milsos
#imbeggingyou	#imbeggingyou
#london	#london
#epub	#epub
#besos	#besos
#proudof5sos	#proudof5sos
#iheart5sos	#iheart5sos
#helpneeded	#helpneeded
#imdesperate	#imdesperate
#csos	#csos
#aldubxdtbysilana	#aldubxdtbysilana
#partner	#partner
#someonehelp	#someonehelp
#cryforhelp	#cryforhelp
#followme5sos	#followme5sos
#harveysos	#harveysos
#darkages	#darkages
#sousvide	#sousvide
#infocomm17	#infocomm17
#womensrights	#womensrights
#nz	#nz
#endtimes	#endtimes
#aneraofdarkness	#aneraofdarkness
#queensofdarkness	#queensofdarkness
#darkdays	#darkdays
#middleages	#middleages
#ages	#ages
#darkhorde	#darkhorde
#nps100	#nps100
#dark	#dark
#darktimes	#darktimes
#infectiousdiseases	#infectiousdiseases
#infectious	#infectious
#infectiousdisease	#infectiousdisease
#airworldtoday	#airworldtoday
#hiv	#hiv
#measles	#measles
#lipstickundermyburkha	#lipstickundermyburkha
#bacteria	#bacteria
#worldpneumoniaday	#worldpneumoniaday
#nair	#nair
#diseases	#diseases
#epidemics	#epidemics
#motivated	#motivated
#unsg	#unsg
#determined	#determined
#notmotivated	#notmotivated
#traininghard	#traininghard
#focused	#focused
#motivatedmonday	#motivatedmonday
#goqiilife	#goqiilife
#getstrong	#getstrong
#staymotivated	#staymotivated
#teep	#teep
#healthy	#healthy
#whatatwat	#whatatwat
#hungryforsuccess	#hungryforsuccess
#feelingmotivated	#feelingmotivated
#aldubmotivated	#aldubmotivated
#moneymotivated	#moneymotivated
#hacker	#hacker
#lifehacker	#lifehacker
#computersecurity	#computersecurity
#hackerrank	#hackerrank
#hackernews	#hackernews
#ethicalhacking	#ethicalhacking
#stopstigma	#stopstigma
#cyberattack	#cyberattack
#hackers	#hackers
#startup	#startup
#geek	#geek
#pontoon	#pontoon
#cybersec	#cybersec
#paybacktime	#paybacktime
#judge	#judge
#judgenot	#judgenot
#thejudge	#thejudge
#crloc37	#crloc37
#bestcover	#bestcover
#stoprush	#stoprush
#jury	#jury
#limbaugh	#limbaugh
#judgecuts	#judgecuts
#followcarter	#followcarter
#markjudge	#markjudge
#harrygirlfollowparty	#harrygirlfollowparty
#crloc38	#crloc38
#law	#law
#judgedredd	#judgedredd
#judgeloya	#judgeloya
#counsel	#counsel
#supremecourt	#supremecourt
#cried	#cried
#pardonmanning	#pardonmanning
#almostcried	#almostcried
#mademecry	#mademecry
#crying	#crying
#pcbb	#pcbb
#stillcrying	#stillcrying
#laughed	#laughed
#sad	#sad
#crycry	#crycry
#andthatswhenistartedcrying	#andthatswhenistartedcrying
#swachhbharatdiwas	#swachhbharatdiwas
#icried	#icried
#soemotional	#soemotional
#healthyfoods	#healthyfoods
#foodpower	#foodpower
#eatinghealthy	#eatinghealthy
#healthyliving	#healthyliving
#healthyeating	#healthyeating
#rawfoods	#rawfoods
#bapbadman	#bapbadman
#tastyfix	#tastyfix
#healthysnacks	#healthysnacks
#elevatetheseason	#elevatetheseason
#healthydiet	#healthydiet
#hmp	#hmp
#healthyfood	#healthyfood
#foods	#foods
#yolo	#yolo
#ldh	#ldh
#thetalkdirtydance	#thetalkdirtydance
#yolomonday	#yolomonday
#employeeoftheyear	#employeeoftheyear
#poppyku	#poppyku
#yolosundays	#yolosundays
#ohwell	#ohwell
#straightthuggin	#straightthuggin
#swag	#swag
#rebelstatus	#rebelstatus
#cbn	#cbn
#taeten	#taeten
#themagicaltoiletisaslut	#themagicaltoiletisaslut
#yoloswag	#yoloswag
#nhs	#nhs
#typea	#typea
#wenurses	#wenurses
#nhscrisis	#nhscrisis
#ukip	#ukip
#ournhspeople	#ournhspeople
#schoolnurses	#schoolnurses
#covid19	#covid19
#collegekidproblems	#collegekidproblems
#votenhs	#votenhs
#eu	#eu
#nmhs	#nmhs
#nhsbirthday	#nhsbirthday
#nhs65	#nhs65
#nhs70	#nhs70
#nhs111	#nhs111
#tzvip	#tzvip
#nurses4bernie	#nurses4bernie
#nhsmillion	#nhsmillion
#onair	#onair
#getlivemedianetwork	#getlivemedianetwork
#playloud	#playloud
#osnplus	#osnplus
#nowplaying	#nowplaying
#radioimpact	#radioimpact
#fmportonair	#fmportonair
#aldubloveonair	#aldubloveonair
#allhitsalldays	#allhitsalldays
#onairnow	#onairnow
#thecountyline	#thecountyline
#onradionow	#onradionow
#nowplayling	#nowplayling
#goonair	#goonair
#noexcuses	#noexcuses
#beonair	#beonair
#bethespark	#bethespark
#whokilledsushant	#whokilledsushant
#ontheair	#ontheair
#maleviolence	#maleviolence
#maleartist	#maleartist
#seekers	#seekers
#thingsworsethanrape	#thingsworsethanrape
#toxicmasculinity	#toxicmasculinity
#male	#male
#genderbasedviolence	#genderbasedviolence
#chongqing	#chongqing
#violence	#violence
#mentoo	#mentoo
#misogyny	#misogyny
#vaw	#vaw
#stopmensabuse	#stopmensabuse
#vawg	#vawg
#noviolence	#noviolence
#stopviolenceagainstwomen	#stopviolenceagainstwomen
#sexualviolence	#sexualviolence
#vevohtyfemale	#vevohtyfemale
#hkers	#hkers
#americanpeople	#americanpeople
#hongkongers	#hongkongers
#nationalsecuritylaw	#nationalsecuritylaw
#hkpoliceterrorists	#hkpoliceterrorists
#cosponsor	#cosponsor
#hongkongprotests	#hongkongprotests
#netdev	#netdev
#hitchhiker	#hitchhiker
#sewol	#sewol
#hkprotests	#hkprotests
#hkgov	#hkgov
#hongkong	#hongkong
#oaklandas	#oaklandas
#hks	#hks
#ccp	#ccp
#toonradio	#toonradio
#seniorconfessions	#seniorconfessions
#hikers	#hikers
#obstacles	#obstacles
#prepaidcreditcard	#prepaidcreditcard
#adversity	#adversity
#barriers	#barriers
#difficulties	#difficulties
#success	#success
#obstructionist	#obstructionist
#giffgaffe4	#giffgaffe4
#obstacle	#obstacle
#mindfulness	#mindfulness
#fearlessmotivation	#fearlessmotivation
#overcoming	#overcoming
#jc9	#jc9
#ww3	#ww3
#teamshea	#teamshea
#ww1	#ww1
#ww	#ww
#nameobamasnewwar	#nameobamasnewwar
#ww84	#ww84
#adjobs	#adjobs
#vancouvernews	#vancouvernews
#worldwar3	#worldwar3
#fhafaruqz	#fhafaruqz
#worldwarthree	#worldwarthree
#russia	#russia
#stopww3	#stopww3
#ww2	#ww2
#worldwariii	#worldwariii
#playlist	#playlist
#spotify	#spotify
#playlist995	#playlist995
#cottonmouth	#cottonmouth
#music	#music
#playlists	#playlists
#zoeysplaylist	#zoeysplaylist
#bikiniready	#bikiniready
#anakkl	#anakkl
#wannawinspotifyplay	#wannawinspotifyplay
#spotifyplaylist	#spotifyplaylist
#onghplaylist	#onghplaylist
#peoplesplaylist	#peoplesplaylist
#hospitalplaylist	#hospitalplaylist
#hotwheels	#hotwheels
#veyron	#veyron
#charliemurphy	#charliemurphy
#hottoys	#hottoys
#ebay	#ebay
#hotboyz	#hotboyz
#hotrides	#hotrides
#alloywheels	#alloywheels
#playmobil	#playmobil
#sfgate	#sfgate
#natgas	#natgas
#cars	#cars
#rkobh	#rkobh
#wheels	#wheels
#diecast	#diecast
#bufvsnyj	#bufvsnyj
#manofthepeople	#manofthepeople
#ofthepeople	#ofthepeople
#gofollowhim	#gofollowhim
#newbritishboybandflwspree	#newbritishboybandflwspree
#manofthehour	#manofthehour
#now	#now
#thepeoplevojsimpson	#thepeoplevojsimpson
#greatman	#greatman
#bestfamily	#bestfamily
#manoftheyear	#manoftheyear
#thepeople	#thepeople
#foodbank	#foodbank
#peoplespresident	#peoplespresident
#topcommunitymembers	#topcommunitymembers
#thepeoplespresident	#thepeoplespresident
#anashout	#anashout
#thechi	#thechi
#atx	#atx
#hiring	#hiring
#itjob	#itjob
#torydictatorship	#torydictatorship
#taemin	#taemin
#hiringnow	#hiringnow
#zaatari	#zaatari
#careerarc	#careerarc
#choicecareers	#choicecareers
#jobs	#jobs
#nowhiring	#nowhiring
#staffphysician	#staffphysician
#projectmgmt	#projectmgmt
#werehiring	#werehiring
#delljobs	#delljobs
#medicareforall	#medicareforall
#expandmedicaidnow	#expandmedicaidnow
#twfanmiiy	#twfanmiiy
#m4a	#m4a
#onwrkgradio	#onwrkgradio
#shamed	#shamed
#medicare	#medicare
#medicare4all	#medicare4all
#heavenknows	#heavenknows
#austinmahonetour	#austinmahonetour
#singlepayernow	#singlepayernow
#universalhealthcare	#universalhealthcare
#medicalfever	#medicalfever
#secreteaters	#secreteaters
#trumpcare	#trumpcare
#singlepayer	#singlepayer
#fu	#fu
#fucancer	#fucancer
#bangerz	#bangerz
#ces2016	#ces2016
#youreabitch	#youreabitch
#fu2016	#fu2016
#fck	#fck
#futd	#futd
#fentyxpuma	#fentyxpuma
#wfu	#wfu
#fcgifu	#fcgifu
#fuku	#fuku
#xrpl	#xrpl
#mileycyrus	#mileycyrus
#tweeryourfriendshipinapicture	#tweeryourfriendshipinapicture
#dyshen	#dyshen
#fuf	#fuf
#cwkungfu	#cwkungfu
#dominant	#dominant
#maledom	#maledom
#submissive	#submissive
#ten	#ten
#lickpussy	#lickpussy
#dominance	#dominance
#dominated	#dominated
#dominating	#dominating
#dominate	#dominate
#sexysportsbabes	#sexysportsbabes
#sukirtikandpalforsexylist2014	#sukirtikandpalforsexylist2014
#moscowmitchmctreason	#moscowmitchmctreason
#bdsm	#bdsm
#fulham	#fulham
#mistress	#mistress
#takebackcontrol	#takebackcontrol
#thisisusfollowspree	#thisisusfollowspree
#horrible	#horrible
#stopbrexitsavebritain	#stopbrexitsavebritain
#takecontrol	#takecontrol
#ivotedleave	#ivotedleave
#changepoliticsforgood	#changepoliticsforgood
#brexit	#brexit
#microprompt	#microprompt
#takebackday	#takebackday
#takemeback	#takemeback
#takingitback	#takingitback
#exportingisgreat	#exportingisgreat
#exitfrombrexit	#exitfrombrexit
#voteleave	#voteleave
#takeitback	#takeitback
#lol	#lol
#lolnot	#lolnot
#lolno	#lolno
#lolreddit	#lolreddit
#healthachieve	#healthachieve
#ptxvol4	#ptxvol4
#funny	#funny
#carsdotcr	#carsdotcr
#cracksmeup	#cracksmeup
#hornytalk	#hornytalk
#lolok	#lolok
#funnytime	#funnytime
#lmfao	#lmfao
#lmaoooo	#lmaoooo
#lolnope	#lolnope
#fakenewscnn	#fakenewscnn
#fanarmy	#fanarmy
#dinnerforone	#dinnerforone
#fraudnewscnn	#fraudnewscnn
#cnn	#cnn
#cnnistrash	#cnnistrash
#fakenews	#fakenews
#fakenewsmedia	#fakenewsmedia
#rape	#rape
#cnnfakenews	#cnnfakenews
#cnnisfakenews	#cnnisfakenews
#newscnn	#newscnn
#specialoffer	#specialoffer
#bigmoasale	#bigmoasale
#offer	#offer
#mockingjaypart1	#mockingjaypart1
#drinkspecials	#drinkspecials
#winning	#winning
#celebmix1d	#celebmix1d
#specials	#specials
#indianews	#indianews
#hu14	#hu14
#lunchspecial	#lunchspecial
#special26	#special26
#profit	#profit
#pllhalloweenspecial	#pllhalloweenspecial
#maidenongmaspecial	#maidenongmaspecial
#weekendspecial	#weekendspecial
#specialevent	#specialevent
#safesystem	#safesystem
#frozen	#frozen
#worldathleticschampionships	#worldathleticschampionships
#disney	#disney
#olaf	#olaf
#frozenfever	#frozenfever
#frozenfour	#frozenfour
#disneyfrozen	#disneyfrozen
#demifrozen	#demifrozen
#frozenyogurt	#frozenyogurt
#vote4trump	#vote4trump
#elsa	#elsa
#anna	#anna
#processimprovement	#processimprovement
#frozen2	#frozen2
#metoo	#metoo
#eyesup	#eyesup
#timesup	#timesup
#toairwest	#toairwest
#sexualharassment	#sexualharassment
#followmetoo	#followmetoo
#congress	#congress
#abusefreeindia	#abusefreeindia
#victimblaming	#victimblaming
#hearmetoo	#hearmetoo
#suicidesquad2	#suicidesquad2
#meetoo	#meetoo
#knowsmetoowell	#knowsmetoowell
#metooindia	#metooindia
#metoomovement	#metoomovement
#graduates	#graduates
#collegestudents	#collegestudents
#students	#students
#newgrad	#newgrad
#hr	#hr
#aptask	#aptask
#traditionnevergraduates	#traditionnevergraduates
#grads	#grads
#graduatejobs	#graduatejobs
#traderforex	#traderforex
#collegegrads	#collegegrads
#collegegraduate	#collegegraduate
#worstbehavior	#worstbehavior
#graduate	#graduate
#traineeships	#traineeships
#copaoro2015	#copaoro2015
#nobodyknows	#nobodyknows
#got7	#got7
#youdontknowme	#youdontknowme
#hungerstrikeforaltaf	#hungerstrikeforaltaf
#kuttythala	#kuttythala
#nooneknows	#nooneknows
#presentyou	#presentyou
#nobody	#nobody
#nobodysafetour	#nobodysafetour
#everybodyknows	#everybodyknows
#theydontknow	#theydontknow
#youllneverknow	#youllneverknow
#lullaby	#lullaby
#knows	#knows
#specialone	#specialone
#onlygodknows	#onlygodknows
#doglover	#doglover
#dog	#dog
#dogmeat	#dogmeat
#chicagopolice	#chicagopolice
#ease	#ease
#says	#says
#doglovers	#doglovers
#luvadorablepets	#luvadorablepets
#doggies	#doggies
#dogfinder	#dogfinder
#cutedogs	#cutedogs
#canine	#canine
#lil	#lil
#perseverance	#perseverance
#dogs	#dogs
#dogsarelove	#dogsarelove
#possibilities	#possibilities
#dogdad	#dogdad
#toilets	#toilets
#bathrooms	#bathrooms
#opendefecation	#opendefecation
#toiletforbabli	#toiletforbabli
#taylorschilling	#taylorschilling
#toiletslavery	#toiletslavery
#toilet	#toilet
#opendefecationfree	#opendefecationfree
#toilets4all	#toilets4all
#donatetoiletstoindia	#donatetoiletstoindia
#worldtoiletday	#worldtoiletday
#amcfearfest	#amcfearfest
#teamcharles	#teamcharles
#plumbing	#plumbing
#fixtures	#fixtures
#bathroom	#bathroom
#googlepay	#googlepay
#googlewallet	#googlewallet
#androidpay	#androidpay
#concertfilms	#concertfilms
#applepay	#applepay
#clydesdale	#clydesdale
#pay	#pay
#googlebooks	#googlebooks
#googlenow	#googlenow
#googlenewsjp	#googlenewsjp
#phonepe	#phonepe
#gcashdaily1k	#gcashdaily1k
#penny	#penny
#taxi	#taxi
#uberpromocode	#uberpromocode
#akbar	#akbar
#blackcab	#blackcab
#lyft	#lyft
#taxiride	#taxiride
#cab	#cab
#faketaxi	#faketaxi
#minicab	#minicab
#designtaxi	#designtaxi
#tfl	#tfl
#taxidriver	#taxidriver
#judgeme	#judgeme
#stbernard	#stbernard
#taxiwaala	#taxiwaala
#uber	#uber
#taxirape	#taxirape
#nw	#nw
#nw200	#nw200
#happynow	#happynow
#moviemarathon	#moviemarathon
#giantsdraft	#giantsdraft
#spaz	#spaz
#nwfollowers	#nwfollowers
#currentlywatching	#currentlywatching
#tnw	#tnw
#replacemovietitlewithbiggie	#replacemovietitlewithbiggie
#nowatching	#nowatching
#rewatch	#rewatch
#classic	#classic
#residentevil2remake	#residentevil2remake
#nw6	#nw6
#nw3	#nw3
#nwprepsnow	#nwprepsnow
#kallysmashup2	#kallysmashup2
#elementary	#elementary
#steal	#steal
#pickpocket	#pickpocket
#stole	#stole
#swift	#swift
#lie	#lie
#buystealtheshowonitunes	#buystealtheshowonitunes
#hiap	#hiap
#annaatthe	#annaatthe
#steals	#steals
#deal	#deal
#stealing	#stealing
#returntosender	#returntosender
#dontstealpossible	#dontstealpossible
#bieberstolefromparamore	#bieberstolefromparamore
#bargain	#bargain
#afterwecollided	#afterwecollided
#collidertvtalk	#collidertvtalk
#hessa	#hessa
#webrokeupbecause	#webrokeupbecause
#powers	#powers
#makemecry	#makemecry
#webrokeup	#webrokeup
#piffhistory	#piffhistory
#after	#after
#uncaged	#uncaged
#collidermovietalk	#collidermovietalk
#thespacebetweenus	#thespacebetweenus
#aftermovie	#aftermovie
#afterwecollidedmovie	#afterwecollidedmovie
#beforeifall	#beforeifall
#justdonated	#justdonated
#fireemblemthreehouses	#fireemblemthreehouses
#fireemblem3houses	#fireemblem3houses
#houses	#houses
#fireemblemheroes	#fireemblemheroes
#batterup	#batterup
#threehouses	#threehouses
#endms	#endms
#fireemblem	#fireemblem
#structurefire	#structurefire
#fe3h	#fe3h
#edelgard	#edelgard
#three	#three
#edeleth	#edeleth
#game4grenfell	#game4grenfell
#exophase	#exophase
#truetrophy	#truetrophy
#celticheroes	#celticheroes
#gamznewz	#gamznewz
#picturebooks	#picturebooks
#blackpanther	#blackpanther
#searchamericanjobs	#searchamericanjobs
#aggiepride	#aggiepride
#fpsgames	#fpsgames
#trueachievement	#trueachievement
#monstertruck	#monstertruck
#globalmnh	#globalmnh
#teammatty	#teammatty
#ivoted	#ivoted
#entomophagy	#entomophagy
#truesteamachievements	#truesteamachievements
#letthemeatcake	#letthemeatcake
#exopopasia	#exopopasia
#ukleaksexposedgeo	#ukleaksexposedgeo
#mytwitteranniversary	#mytwitteranniversary
#minjoon	#minjoon
#twitter10years	#twitter10years
#sameguy	#sameguy
#birthdaytweet	#birthdaytweet
#crypto	#crypto
#internet	#internet
#tweetyourbirthday	#tweetyourbirthday
#anniversary	#anniversary
#twitterversary	#twitterversary
#guccigang	#guccigang
#howlonghaveibeenontwitter	#howlonghaveibeenontwitter
#twitter	#twitter
#mybirthday	#mybirthday
#happybirthdaytwitter	#happybirthdaytwitter
#poraut	#poraut
#thx	#thx
#thxbirthcontrol	#thxbirthcontrol
#muchappreciated	#muchappreciated
#dolby	#dolby
#dmmemadison	#dmmemadison
#cool	#cool
#keelections2013	#keelections2013
#tnx	#tnx
#thxmom	#thxmom
#gotit	#gotit
#saibuhari	#saibuhari
#thnx	#thnx
#youthx	#youthx
#workplace	#workplace
#tbt	#tbt
#stereophonics	#stereophonics
#godismyhope	#godismyhope
#throwbackthurs	#throwbackthurs
#subramanianswamy	#subramanianswamy
#throwback	#throwback
#tbt2017	#tbt2017
#throwbackfriday	#throwbackfriday
#tbtxfiles	#tbtxfiles
#ctbt	#ctbt
#mommygotboobs	#mommygotboobs
#truthfmdawnbreaktbt	#truthfmdawnbreaktbt
#summer	#summer
#throwbackthurday	#throwbackthurday
#tbt2016	#tbt2016
#family	#family
#tds	#tds
#masterbating	#masterbating
#td9	#td9
#tdsbreakingnews	#tdsbreakingnews
#palmoilkills	#palmoilkills
#onhwys	#onhwys
#dds	#dds
#ds	#ds
#liberalismisamentaldisorder	#liberalismisamentaldisorder
#kribo	#kribo
#trumpdementiasyndrome	#trumpdementiasyndrome
#tdstop5	#tdstop5
#tdr	#tdr
#touchdowns	#touchdowns
#tdgn	#tdgn
#tdl	#tdl
#methodology	#methodology
#biotechnologypharmaceuticals	#biotechnologypharmaceuticals
#qualitative	#qualitative
#change	#change
#methods	#methods
#utwx	#utwx
#sgfood	#sgfood
#projectbased	#projectbased
#computationalthinking	#computationalthinking
#analytical	#analytical
#dopeness	#dopeness
#ipcc	#ipcc
#bilawalbhuttozardari	#bilawalbhuttozardari
#agilecoach	#agilecoach
#method	#method
#equation	#equation
#scientificmethod	#scientificmethod
#plasticpollution	#plasticpollution
#beatplasticpollution	#beatplasticpollution
#plasticfree	#plasticfree
#singleuseplastics	#singleuseplastics
#galantis	#galantis
#plasticpollutes	#plasticpollutes
#pollution	#pollution
#endplasticpollution	#endplasticpollution
#ocean	#ocean
#angrybirdsstarwars	#angrybirdsstarwars
#mk	#mk
#plastic	#plastic
#standwithhk	#standwithhk
#fightforfreedom	#fightforfreedom
#yohanestony	#yohanestony
#freedomhk	#freedomhk
#freehongkong	#freehongkong
#pelosi	#pelosi
#standwithphil	#standwithphil
#standwithhillary	#standwithhillary
#standwithisrael	#standwithisrael
#standwithhongkong	#standwithhongkong
#worldhistory	#worldhistory
#majorxpress	#majorxpress
#futuretweet	#futuretweet
#dlb	#dlb
#newprofilepic	#newprofilepic
#freespeechrally	#freespeechrally
#newprofiiepic	#newprofiiepic
#travelblogs	#travelblogs
#newpic	#newpic
#newheader	#newheader
#staystrong	#staystrong
#wonderwoman	#wonderwoman
#profilepic	#profilepic
#newprofilepicture	#newprofilepicture
#newprofiepic	#newprofiepic
#residentevil	#residentevil
#cryptojacking	#cryptojacking
#selfshot	#selfshot
#evh	#evh
#thejewelrycorneratwm	#thejewelrycorneratwm
#dirkgently	#dirkgently
#selfieboobs	#selfieboobs
#nsfw	#nsfw
#selfie	#selfie
#selfbuild	#selfbuild
#mirrorphotos	#mirrorphotos
#selfshots	#selfshots
#idolssa	#idolssa
#selfmanagement	#selfmanagement
#hotnudeselfie	#hotnudeselfie
#etsyretweet	#etsyretweet
#avicontest	#avicontest
#uhc2030	#uhc2030
#start	#start
#goodstart	#goodstart
#badstart	#badstart
#earnonline	#earnonline
#mallowmummies	#mallowmummies
#starthere	#starthere
#mens	#mens
#howtomakemoney	#howtomakemoney
#tumbling	#tumbling
#starter	#starter
#flash	#flash
#proclaimingchrist	#proclaimingchrist
#startagain	#startagain
#join	#join
#valvrave	#valvrave
#greatstart	#greatstart
#growyourown	#growyourown
#allotment	#allotment
#growyourbusiness	#growyourbusiness
#growyourownfood	#growyourownfood
#gardeningtips	#gardeningtips
#organicgardening	#organicgardening
#girlmeetsworldseason4	#girlmeetsworldseason4
#ragetweet	#ragetweet
#shiiiit	#shiiiit
#getyourown	#getyourown
#gyo	#gyo
#justeat	#justeat
#riwx	#riwx
#eat	#eat
#tweetwhatyoueat	#tweetwhatyoueat
#alfiewantsfood	#alfiewantsfood
#imstarving	#imstarving
#feedme	#feedme
#askhoogs	#askhoogs
#eatit	#eatit
#ubereats	#ubereats
#eatwellforless	#eatwellforless
#justsad	#justsad
#eatitup	#eatitup
#uwg20	#uwg20
#foodie	#foodie
#just	#just
#kfc	#kfc
#manvfood	#manvfood
#eatout	#eatout
#entertainer	#entertainer
#kathryn18	#kathryn18
#emabieggestfansjustinbieber	#emabieggestfansjustinbieber
#mtvstarsbritneyspears	#mtvstarsbritneyspears
#songwriter	#songwriter
#entertainers	#entertainers
#onekiss	#onekiss
#favoriteactor	#favoriteactor
#comedian	#comedian
#enjoythebeat	#enjoythebeat
#artist	#artist
#gignews	#gignews
#singer	#singer
#entertaineroftheyear	#entertaineroftheyear
#performer	#performer
#freetixmusicbankjkt	#freetixmusicbankjkt
#hilarious	#hilarious
#thelaughtershowep15	#thelaughtershowep15
#funniest	#funniest
#fuckinghilarious	#fuckinghilarious
#brentlaughs	#brentlaughs
#thelaughtershowep16	#thelaughtershowep16
#loveit	#loveit
#imhilarious	#imhilarious
#funnyordie	#funnyordie
#thoughsinthehallway	#thoughsinthehallway
#jumping	#jumping
#crackingup	#crackingup
#sbtsmadness	#sbtsmadness
#picoftheday	#picoftheday
#pictureoftheday	#pictureoftheday
#popularphotos	#popularphotos
#photoftheday	#photoftheday
#sneakerboutique	#sneakerboutique
#pic8	#pic8
#mamavation	#mamavation
#sabfanoftheday	#sabfanoftheday
#photography	#photography
#ggpic	#ggpic
#picoftheweek	#picoftheweek
#instabrum	#instabrum
#littleone	#littleone
#dailyphoto	#dailyphoto
#qouteoftheday	#qouteoftheday
#pic	#pic
#photooftheday	#photooftheday
#dropbox	#dropbox
#modilacyber4rt	#modilacyber4rt
#vgma	#vgma
#gmail	#gmail
#evernote	#evernote
#wine	#wine
#alwaysrising	#alwaysrising
#dropzone	#dropzone
#dropoutbernie	#dropoutbernie
#microsoft	#microsoft
#cloud	#cloud
#virtualbox	#virtualbox
#rackspace	#rackspace
#skydrive	#skydrive
#mailchimp	#mailchimp
#dropdangle	#dropdangle
#honortweet	#honortweet
#publichealth	#publichealth
#sexvideo	#sexvideo
#communityhealth	#communityhealth
#smm	#smm
#lupusawarenessmonth	#lupusawarenessmonth
#phealth	#phealth
#healthruwords	#healthruwords
#healthpolicy	#healthpolicy
#futureofhealth	#futureofhealth
#healthequity	#healthequity
#publichealthcrisis	#publichealthcrisis
#zika	#zika
#au2017	#au2017
#public	#public
#coldjustice	#coldjustice
#peoplevsoj	#peoplevsoj
#justice4shahzeb	#justice4shahzeb
#murderinsuccessville	#murderinsuccessville
#justiceforbap	#justiceforbap
#integrated	#integrated
#myhero	#myhero
#cold	#cold
#oxygen	#oxygen
#notjudging	#notjudging
#getglue	#getglue
#justice	#justice
#hardcorejustice	#hardcorejustice
#smartjustice	#smartjustice
#egsubbiegiveaway	#egsubbiegiveaway
#chicagojustice	#chicagojustice
#justiceiscoming	#justiceiscoming
#transgender	#transgender
#transgendered	#transgendered
#transtakeover	#transtakeover
#ftm	#ftm
#protecttranstroops	#protecttranstroops
#transwomenarewomen	#transwomenarewomen
#azteca	#azteca
#bisexual	#bisexual
#trans	#trans
#lgbtnews	#lgbtnews
#femaletomale	#femaletomale
#lesbian	#lesbian
#muscles	#muscles
#genderqeer	#genderqeer
#wows	#wows
#adnd	#adnd
#glbtq	#glbtq
#greatdepression	#greatdepression
#womenwhoinspire	#womenwhoinspire
#depressionisreal	#depressionisreal
#livingwithdepressionis	#livingwithdepressionis
#bipolar	#bipolar
#anxiety	#anxiety
#mentalillness	#mentalillness
#postpartumdepression	#postpartumdepression
#wheyhey	#wheyhey
#fuckdepression	#fuckdepression
#asksrt	#asksrt
#psychotherapy	#psychotherapy
#depressionsucks	#depressionsucks
#trumpdepression	#trumpdepression
#cheerstothat	#cheerstothat
#hstylesforkeira24bday	#hstylesforkeira24bday
#jesuccessparty	#jesuccessparty
#icawestjava	#icawestjava
#pouritup	#pouritup
#illdrinktothat	#illdrinktothat
#singlelife	#singlelife
#reacttothat	#reacttothat
#showsthatneedtocomeback	#showsthatneedtocomeback
#kejurdajabar	#kejurdajabar
#cheerstotheweekend	#cheerstotheweekend
#isthattomuchtoask	#isthattomuchtoask
#applepie	#applepie
#cheerstothefreakinweekend	#cheerstothefreakinweekend
#tgif	#tgif
#sooo	#sooo
#latestbusinessnews	#latestbusinessnews
#indiabombay	#indiabombay
#industrynews	#industrynews
#usbiz	#usbiz
#wrongchoiceact	#wrongchoiceact
#citibusinessnews	#citibusinessnews
#licklife	#licklife
#business	#business
#forexnewsrobot	#forexnewsrobot
#biznews	#biznews
#rainbowcake	#rainbowcake
#mindright	#mindright
#goals	#goals
#dedicated	#dedicated
#focus100	#focus100
#laserfocused	#laserfocused
#focus	#focus
#tradewars	#tradewars
#westcdnag	#westcdnag
#zenfone	#zenfone
#needtofocus	#needtofocus
#dailymotivation	#dailymotivation
#stayingfocused	#stayingfocused
#focusedbc	#focusedbc
#nodaysoff	#nodaysoff
#nooffdays	#nooffdays
#teamnodaysoff	#teamnodaysoff
#saturdaymotivation	#saturdaymotivation
#grind	#grind
#grindneverstops	#grindneverstops
#thosedays	#thosedays
#longdays	#longdays
#blessed	#blessed
#mffl	#mffl
#tastetest	#tastetest
#daysoff	#daysoff
#decentralized	#decentralized
#cryptocurency	#cryptocurency
#blockchaintechnology	#blockchaintechnology
#cryptocurrency	#cryptocurrency
#decentralised	#decentralised
#datablockchain	#datablockchain
#decentralize	#decentralize
#teamstrong	#teamstrong
#participatorybudgeting	#participatorybudgeting
#blockchain	#blockchain
#decentralization	#decentralization
#crimeminister	#crimeminister
#openledger	#openledger
#asking	#asking
#fundraising	#fundraising
#charity	#charity
#belieberseguebelieber	#belieberseguebelieber
#thedayofthedoctor	#thedayofthedoctor
#nonprofit	#nonprofit
#fundraisingfriday	#fundraisingfriday
#smallcharities	#smallcharities
#fundraise	#fundraise
#indigenousrights	#indigenousrights
#easyfundraising	#easyfundraising
#fundraiser	#fundraiser
#ethicalgiving	#ethicalgiving
#indiegogolife	#indiegogolife
#justsponsored	#justsponsored
#fundraisers	#fundraisers
#handsoff	#handsoff
#hands	#hands
#ahca	#ahca
#trumpmustresign	#trumpmustresign
#medicaid	#medicaid
#censuretrump	#censuretrump
#handsoffmybc	#handsoffmybc
#handsdown	#handsdown
#nocuts	#nocuts
#dax	#dax
#defundit	#defundit
#handsup	#handsup
#aldubxdtbysoulmates	#aldubxdtbysoulmates
#handsoffcaster	#handsoffcaster
#trumpbudget	#trumpbudget
#off	#off
#resignnowtrump	#resignnowtrump
#gayyyy	#gayyyy
#androiddev	#androiddev
#devtools	#devtools
#androidprobs	#androidprobs
#iosdev	#iosdev
#gamedev	#gamedev
#itunesradio	#itunesradio
#indiedev	#indiedev
#mobileappdevelopment	#mobileappdevelopment
#srsroot	#srsroot
#iphonedev	#iphonedev
#killingfloor2	#killingfloor2
#newstalk	#newstalk
#dev	#dev
#androidstudio	#androidstudio
#dumkanayarang	#dumkanayarang
#justiceformyanmar	#justiceformyanmar
#btsinhongkong	#btsinhongkong
#standwithncwomen	#standwithncwomen
#environment	#environment
#hongkongprotesters	#hongkongprotesters
#wesupportjonghyun	#wesupportjonghyun
#hongkongpolice	#hongkongpolice
#activelifestyle	#activelifestyle
#standwith	#standwith
#save12hkyouths	#save12hkyouths
#policebrutality	#policebrutality
#standwithjemele	#standwithjemele
#herbs	#herbs
#stayprayedup	#stayprayedup
#medicinal	#medicinal
#spices	#spices
#superfoods	#superfoods
#essentialoils	#essentialoils
#micah	#micah
#thatcherjoeprank	#thatcherjoeprank
#herbalmedicine	#herbalmedicine
#botanicalgardens	#botanicalgardens
#aa100	#aa100
#microgreens	#microgreens
#herb	#herb
#vegetables	#vegetables
#listenlive	#listenlive
#letlive	#letlive
#pridefest	#pridefest
#slangsmithradio	#slangsmithradio
#wkoolradio	#wkoolradio
#pollinators	#pollinators
#listennow	#listennow
#bostonrockradio	#bostonrockradio
#watchlive	#watchlive
#listen	#listen
#hotlineradio	#hotlineradio
#cpcjesus	#cpcjesus
#np	#np
#liveandletlive	#liveandletlive
#only1djsmitty	#only1djsmitty
#dexradiolive	#dexradiolive
#flour	#flour
#octms	#octms
#justinbieberconfenix	#justinbieberconfenix
#breads	#breads
#wholegrain	#wholegrain
#sugar	#sugar
#breadandbeans	#breadandbeans
#sourdough	#sourdough
#baking	#baking
#hannibal	#hannibal
#breadandbutter	#breadandbutter
#grains	#grains
#breadpudding	#breadpudding
#cereals	#cereals
#bread	#bread
#whatmakeshillaryshortcircuit	#whatmakeshillaryshortcircuit
#earthquakes	#earthquakes
#dirtydonald	#dirtydonald
#iheartawards2021	#iheartawards2021
#dirtydems	#dirtydems
#donaldtrumpisthetypeofguy	#donaldtrumpisthetypeofguy
#loves	#loves
#dirtyharry	#dirtyharry
#dangerousdonald	#dangerousdonald
#twitterontheshitter	#twitterontheshitter
#dirtybastard	#dirtybastard
#spendingreview	#spendingreview
#greencities	#greencities
#donthecon	#donthecon
#nevertrump	#nevertrump
#harlemriverdrive	#harlemriverdrive
#imwithher	#imwithher
#sleazytrump	#sleazytrump
#dirtydon	#dirtydon
#btw	#btw
#dwp15	#dwp15
#btw17	#btw17
#bytheway	#bytheway
#hrtechconf	#hrtechconf
#iwannabewithu	#iwannabewithu
#florida	#florida
#btw13	#btw13
#energyefficient	#energyefficient
#jsyk	#jsyk
#vegas	#vegas
#justaheadsup	#justaheadsup
#btww	#btww
#btwlisteningparty	#btwlisteningparty
#attbizsummit	#attbizsummit
#girlsofmygirlfund	#girlsofmygirlfund
#fyi	#fyi
#rentals	#rentals
#sepsis	#sepsis
#vacationrentals	#vacationrentals
#rental	#rental
#condominiums	#condominiums
#forrent	#forrent
#apartmentforrent	#apartmentforrent
#usefulupdates	#usefulupdates
#apartments	#apartments
#residentialrental	#residentialrental
#rent	#rent
#evans	#evans
#vacationrental	#vacationrental
#rentalproperty	#rentalproperty
#sony	#sony
#sonye3	#sonye3
#consumerelectronics	#consumerelectronics
#sonyces	#sonyces
#iris	#iris
#boycottsony	#boycottsony
#xperiaz4	#xperiaz4
#jpop	#jpop
#nomorecable	#nomorecable
#iphone	#iphone
#playstation	#playstation
#muvb	#muvb
#playstation4	#playstation4
#sonypictures	#sonypictures
#sonysupportsrape	#sonysupportsrape
#wakeupsony	#wakeupsony
#decade	#decade
#goldenyears	#goldenyears
#ilove10s	#ilove10s
#trapping	#trapping
#hottest	#hottest
#goldenage	#goldenage
#decades	#decades
#aldubtp3years	#aldubtp3years
#locomotives	#locomotives
#mydecade	#mydecade
#rpglifeuk	#rpglifeuk
#decadeofdecay	#decadeofdecay
#iconic	#iconic
#ilove00s	#ilove00s
#hits10s	#hits10s
#culturenight	#culturenight
#years	#years
#joinnow	#joinnow
#followi7f	#followi7f
#signup	#signup
#foodenvy	#foodenvy
#bigoliveonemillionfans	#bigoliveonemillionfans
#oyo	#oyo
#jointogether	#jointogether
#signups	#signups
#joining	#joining
#seyjoin	#seyjoin
#joinmu	#joinmu
#us	#us
#tntweeters	#tntweeters
#likebux	#likebux
#brainyquote	#brainyquote
#save	#save
#lloydhappinessmeter	#lloydhappinessmeter
#localisation	#localisation
#smilesbyetisalat	#smilesbyetisalat
#savesavesave	#savesavesave
#djiphantom	#djiphantom
#buxoff	#buxoff
#discounts	#discounts
#joyrewards	#joyrewards
#savebensolo	#savebensolo
#savemoney	#savemoney
#onlinedeals	#onlinedeals
#savetwitter	#savetwitter
#saveournhs	#saveournhs
#savejpwishtown	#savejpwishtown
#deals	#deals
#thighhighs	#thighhighs
#dx10m	#dx10m
#sexy	#sexy
#npweek	#npweek
#dover	#dover
#heels	#heels
#thighthursday	#thighthursday
#nylonfetish	#nylonfetish
#thighhigh	#thighhigh
#thighhighboots	#thighhighboots
#badpuns	#badpuns
#mtnhitmaker5	#mtnhitmaker5
#zhejiang	#zhejiang
#stockings	#stockings
#thighhighthursday	#thighhighthursday
#sexylegs	#sexylegs
#pantyhosefetish	#pantyhosefetish
#thighboots	#thighboots
#magic	#magic
#secretofmana	#secretofmana
#moviemagic	#moviemagic
#letsgomagic	#letsgomagic
#fantasy	#fantasy
#casket	#casket
#mtg	#mtg
#becausemagic	#becausemagic
#huntshowdown	#huntshowdown
#magicwand	#magicwand
#foreverorange	#foreverorange
#magictrick	#magictrick
#dragonmagic	#dragonmagic
#bluemagic	#bluemagic
#theriver1magic	#theriver1magic
#magicthegathering	#magicthegathering
#puremagic	#puremagic
#livingmybestlife	#livingmybestlife
#livinglife	#livinglife
#bestlife	#bestlife
#lovinglife	#lovinglife
#livingthehighlife	#livingthehighlife
#goodmorning	#goodmorning
#thelittlemermaid	#thelittlemermaid
#mylife	#mylife
#liveyourbestlife	#liveyourbestlife
#livinthelife	#livinthelife
#livingthegoodlife	#livingthegoodlife
#ilovelife	#ilovelife
#ilovemyself	#ilovemyself
#infobeasiswa	#infobeasiswa
#goodvibes	#goodvibes
#inmylife	#inmylife
#racewars	#racewars
#indiafightscorruption	#indiafightscorruption
#varsityblues	#varsityblues
#fantasticallycorrupt	#fantasticallycorrupt
#bribes	#bribes
#modiwaroncorruption	#modiwaroncorruption
#tsunami2004	#tsunami2004
#government	#government
#unitedagainstcorruption	#unitedagainstcorruption
#confrontcorruption	#confrontcorruption
#democracy	#democracy
#corruptioncase	#corruptioncase
#corruptionfreergukt	#corruptionfreergukt
#anticorruption	#anticorruption
#racketeering	#racketeering
#zuma	#zuma
#fifacorruption	#fifacorruption
#opensource	#opensource
#openshift	#openshift
#cloudfoundry	#cloudfoundry
#openerp	#openerp
#vocuswebinar	#vocuswebinar
#freesoftware	#freesoftware
#daecon	#daecon
#openrp	#openrp
#freeware	#freeware
#opengov	#opengov
#karnagerc	#karnagerc
#openborders	#openborders
#aquaponics	#aquaponics
#openstack	#openstack
#linux	#linux
#openwhisk	#openwhisk
#brosis	#brosis
#shadowbanning	#shadowbanning
#fit4mom	#fit4mom
#censoring	#censoring
#lovehaterelationship	#lovehaterelationship
#voldemort	#voldemort
#pinhead	#pinhead
#ryzen	#ryzen
#shadowbrokers	#shadowbrokers
#censorship	#censorship
#shadowbanned	#shadowbanned
#shadowban	#shadowban
#twittercensorship	#twittercensorship
#humana	#humana
#itunes	#itunes
#spotifysingles	#spotifysingles
#forbesnews	#forbesnews
#spotifywrapped	#spotifywrapped
#satech	#satech
#googleplaymusic	#googleplaymusic
#ker	#ker
#hiphoprequest	#hiphoprequest
#topdancesong	#topdancesong
#spotifycharts	#spotifycharts
#discount	#discount
#discountdoublecheck	#discountdoublecheck
#keerthysuresh	#keerthysuresh
#discountschoolsupplies	#discountschoolsupplies
#vouchercodes	#vouchercodes
#dealsofday	#dealsofday
#vouchersget	#vouchersget
#studentdiscount	#studentdiscount
#onsale	#onsale
#slbfcb	#slbfcb
#hhbuy	#hhbuy
#jamesharden	#jamesharden
#discountcode	#discountcode
#buy	#buy
#couponcodes	#couponcodes
#mentalstrength	#mentalstrength
#mentalbreakdown	#mentalbreakdown
#innerstrength	#innerstrength
#justinbieberfollowparty	#justinbieberfollowparty
#strength	#strength
#befikreon9th	#befikreon9th
#mental	#mental
#mentallystrong	#mentallystrong
#slingnews	#slingnews
#mentaltoughness	#mentaltoughness
#strongertogether	#strongertogether
#shilpiansstrongertogether	#shilpiansstrongertogether
#askhunterhayes	#askhunterhayes
#resistance	#resistance
#unitedtogether	#unitedtogether
#facilitation	#facilitation
#togetherstronger	#togetherstronger
#werisetogether	#werisetogether
#demsinphilly	#demsinphilly
#together	#together
#toughertogether	#toughertogether
#noton	#noton
#togetherwearestronger	#togetherwearestronger
#togetherweinspire	#togetherweinspire
#digitalmarketing	#digitalmarketing
#marketing	#marketing
#seomarketing	#seomarketing
#wreckingbail	#wreckingbail
#digitalmarketers	#digitalmarketers
#visualcontenting	#visualcontenting
#marketingdigital	#marketingdigital
#digitaladvertising	#digitaladvertising
#pfc	#pfc
#socialmedia	#socialmedia
#websitemarketing	#websitemarketing
#emarketing	#emarketing
#marketingonline	#marketingonline
#rdr2	#rdr2
#digital	#digital
#seo	#seo
#trumpresignnow	#trumpresignnow
#tune3reeradio	#tune3reeradio
#peoplenow	#peoplenow
#channel80	#channel80
#pittsburgh	#pittsburgh
#anon	#anon
#gonow	#gonow
#verizonup	#verizonup
#boho	#boho
#tunein	#tunein
#promobuzz	#promobuzz
#finbannow	#finbannow
#notnow	#notnow
#playing	#playing
#remainernow	#remainernow
#time	#time
#condolences	#condolences
#sympathy	#sympathy
#assassinscreedodyssey	#assassinscreedodyssey
#prayformancester	#prayformancester
#charlotteactionescorts	#charlotteactionescorts
#heartfelt	#heartfelt
#sly	#sly
#terroristsympathiser	#terroristsympathiser
#prayers	#prayers
#thoughtsandprayers	#thoughtsandprayers
#building	#building
#sorrow	#sorrow
#grieving	#grieving
#pakistan	#pakistan
#restinpeace	#restinpeace
#omctragedy	#omctragedy
#ripbobbikristina	#ripbobbikristina
#nbatv	#nbatv
#impressive	#impressive
#neighbourhoodplanning	#neighbourhoodplanning
#impressed	#impressed
#porn	#porn
#askgigi	#askgigi
#stunninghknkj	#stunninghknkj
#lcam	#lcam
#adult	#adult
#lfhe	#lfhe
#veryinteresting	#veryinteresting
#astonishing	#astonishing
#remarkable	#remarkable
#famousaf	#famousaf
#noteworthy	#noteworthy
#stunning	#stunning
#speedflying	#speedflying
#newsalert	#newsalert
#basingstoke	#basingstoke
#indiannews	#indiannews
#sagealert	#sagealert
#sickindianewschannel	#sickindianewschannel
#amo	#amo
#update	#update
#venture	#venture
#newsupdate	#newsupdate
#westbengal	#westbengal
#newsalertng	#newsalertng
#telugunews	#telugunews
#simpleton	#simpleton
#amongus	#amongus
#newyorknewyork	#newyorknewyork
#hardwell	#hardwell
#newsupdates	#newsupdates
#customerexperience	#customerexperience
#employeeexperience	#employeeexperience
#patientexperience	#patientexperience
#huaweip40series	#huaweip40series
#customerjourney	#customerjourney
#customerservice	#customerservice
#customer	#customer
#cx	#cx
#customersuccess	#customersuccess
#biggovsucks	#biggovsucks
#x100s	#x100s
#custexp	#custexp
#customerengagement	#customerengagement
#voiceofcustomer	#voiceofcustomer
#fact	#fact
#sciencefact	#sciencefact
#teamleader	#teamleader
#youaremoreattractiveif	#youaremoreattractiveif
#prolife	#prolife
#gahdamn	#gahdamn
#zerriefact	#zerriefact
#foodfact	#foodfact
#youremoreattractiveif	#youremoreattractiveif
#uselessfact	#uselessfact
#weirdfact	#weirdfact
#fridayfunfact	#fridayfunfact
#baekhyunfact	#baekhyunfact
#sexisgoodwhen	#sexisgoodwhen
#alitasequel	#alitasequel
#truefacts	#truefacts
#dayoff	#dayoff
#layin	#layin
#finally	#finally
#weekoff	#weekoff
#dayofftomorrow	#dayofftomorrow
#mydayoff	#mydayoff
#chillday	#chillday
#aoclied	#aoclied
#offday	#offday
#work	#work
#branchbanking	#branchbanking
#shutdowna14	#shutdowna14
#tokyoolympics	#tokyoolympics
#youtholympics	#youtholympics
#olympics2016	#olympics2016
#olympics	#olympics
#glencove	#glencove
#olympictrials	#olympictrials
#tokyo2020	#tokyo2020
#specialolympicsworldgames	#specialolympicsworldgames
#teammsiaolympics	#teammsiaolympics
#olympicgames2018	#olympicgames2018
#fctokyo	#fctokyo
#beijing2022	#beijing2022
#riototokyo	#riototokyo
#tokyo	#tokyo
#thoughtsduringsex	#thoughtsduringsex
#rotr	#rotr
#badminton	#badminton
#sketchbook	#sketchbook
#inkdrawing	#inkdrawing
#sketchcard	#sketchcard
#scrapbook	#scrapbook
#bromance	#bromance
#watercolors	#watercolors
#drawingillustration	#drawingillustration
#aifw	#aifw
#sketch50	#sketch50
#pencilart	#pencilart
#shoebox	#shoebox
#pencilsketch	#pencilsketch
#hsu	#hsu
#sketchcards	#sketchcards
#pencildrawing	#pencildrawing
#sketch	#sketch
#drawing	#drawing
#ill	#ill
#sickly	#sickly
#notill	#notill
#indifferent	#indifferent
#oneill	#oneill
#hatebeingill	#hatebeingill
#illpay	#illpay
#tired	#tired
#bedridden	#bedridden
#bed	#bed
#mentallyill	#mentallyill
#dc4l	#dc4l
#dragmedownmusicvideo	#dragmedownmusicvideo
#gettingsick	#gettingsick
#soill	#soill
#fuckbeingsick	#fuckbeingsick
#notfeelingwell	#notfeelingwell
#workhappy	#workhappy
#jobsatisfaction	#jobsatisfaction
#doingwork	#doingwork
#workplacewellbeing	#workplacewellbeing
#hellowork	#hellowork
#leekwangsoo	#leekwangsoo
#workwednesday	#workwednesday
#goodwork	#goodwork
#applytoday	#applytoday
#sohappy	#sohappy
#lovewhereyouwork	#lovewhereyouwork
#repeat	#repeat
#greatwork	#greatwork
#teamtity	#teamtity
#ff	#ff
#instantfollowback	#instantfollowback
#danielcraig	#danielcraig
#wff	#wff
#fjm1	#fjm1
#t4f	#t4f
#ff15	#ff15
#tfb	#tfb
#jff	#jff
#twit4follow	#twit4follow
#humannature	#humannature
#ineedanap	#ineedanap
#ff14	#ff14
#ff7	#ff7
#abff	#abff
#votebluenomatterwho	#votebluenomatterwho
#afldonssaints	#afldonssaints
#nomatterwhat	#nomatterwhat
#votebluetoendthisnightmare	#votebluetoendthisnightmare
#resist	#resist
#votebluenomatterwho2020	#votebluenomatterwho2020
#voteonlytheyoung	#voteonlytheyoung
#anthonyfauci	#anthonyfauci
#bluenomatterwho	#bluenomatterwho
#voteblue	#voteblue
#votebluetosaveamerica	#votebluetosaveamerica
#passinterstudents	#passinterstudents
#makingamericagreatagain	#makingamericagreatagain
#croozefmnews	#croozefmnews
#trumptrain	#trumptrain
#onlyinamerica	#onlyinamerica
#americansfirst	#americansfirst
#under10kgang	#under10kgang
#thevampsinamerica	#thevampsinamerica
#vetsfirst	#vetsfirst
#makeamericagreatagain	#makeamericagreatagain
#americalast	#americalast
#america	#america
#america1st	#america1st
#makeamericawhiteagain	#makeamericawhiteagain
#mlmtips	#mlmtips
#aiteocup	#aiteocup
#aiethics	#aiethics
#machinelearning	#machinelearning
#huddersfieldis	#huddersfieldis
#icai	#icai
#gots7	#gots7
#aion	#aion
#ai29	#ai29
#akai	#akai
#machineintelligence	#machineintelligence
#artificialintelligence	#artificialintelligence
#coinbrawl	#coinbrawl
#iot	#iot
#cognitivecomputing	#cognitivecomputing
#emergingtechnologies	#emergingtechnologies
#internetofthings	#internetofthings
#industrialiot	#industrialiot
#m2m	#m2m
#industriainternetofthings	#industriainternetofthings
#ioe	#ioe
#things	#things
#aborticidalricharddawkins	#aborticidalricharddawkins
#internet4all	#internet4all
#nominees	#nominees
#internetofeverything	#internetofeverything
#industrialinternet	#industrialinternet
#toning	#toning
#iiot	#iiot
#allinternet	#allinternet
#presidementia	#presidementia
#dementiaawareness	#dementiaawareness
#happybirthdayleighanne	#happybirthdayleighanne
#eatingdisorderawarenessweek	#eatingdisorderawarenessweek
#lukecage	#lukecage
#trumpdementia	#trumpdementia
#dementiadon	#dementiadon
#presley	#presley
#presstitute	#presstitute
#alzheimer	#alzheimer
#dementia	#dementia
#voteleavebrokethelaw	#voteleavebrokethelaw
#sickgirlprobs	#sickgirlprobs
#revokearticle50	#revokearticle50
#thelaw	#thelaw
#voterfraudisreal	#voterfraudisreal
#stopbrexit	#stopbrexit
#leavemeansleave	#leavemeansleave
#breakingthelaw	#breakingthelaw
#voteremain	#voteremain
#votelen	#votelen
#deensanwoola	#deensanwoola
#votelorde	#votelorde
#itsthelaw	#itsthelaw
#racingextinction	#racingextinction
#deniedmyvote	#deniedmyvote
#votejlaw	#votejlaw
#superfan	#superfan
#fanforlife	#fanforlife
#sparky	#sparky
#saddahaq	#saddahaq
#westie	#westie
#fan4life	#fan4life
#livefunfairwithfdd	#livefunfairwithfdd
#jika	#jika
#superfans	#superfans
#ddcascam	#ddcascam
#superfly	#superfly
#jep	#jep
#superfanfriday	#superfanfriday
#fanforever	#fanforever
#shivajimaharaj	#shivajimaharaj
#lenny	#lenny
#obsession	#obsession
#nervous	#nervous
#myaddiction	#myaddiction
#newobsession	#newobsession
#crazymofosloveniallhoran	#crazymofosloveniallhoran
#missworld2013	#missworld2013
#fragrance	#fragrance
#izombieobsessed	#izombieobsessed
#lovelanguage	#lovelanguage
#myobsession	#myobsession
#obsessed	#obsessed
#rydelsteaparty	#rydelsteaparty
#infosec	#infosec
#bctsports	#bctsports
#cyberthreats	#cyberthreats
#cybersecuritynews	#cybersecuritynews
#breaches	#breaches
#ransomeware	#ransomeware
#depokcybersecurity	#depokcybersecurity
#cyberespionage	#cyberespionage
#cybersecurityawarenessmonth	#cybersecurityawarenessmonth
#advancehbdmaheshbabu	#advancehbdmaheshbabu
#tommison	#tommison
#privacy	#privacy
#deeplearning	#deeplearning
#deep	#deep
#reinforcementlearning	#reinforcementlearning
#pytorch	#pytorch
#neuralnetworks	#neuralnetworks
#ayyyyy	#ayyyyy
#datascience	#datascience
#nba2kleague	#nba2kleague
#deepthroating	#deepthroating
#learning	#learning
#deeperlearning	#deeperlearning
#milletineserikapatilamaz	#milletineserikapatilamaz
#fml	#fml
#arendsvlei	#arendsvlei
#fmylife	#fmylife
#awkward	#awkward
#sostressed	#sostressed
#trackprobs	#trackprobs
#busylife	#busylife
#truththatrocks	#truththatrocks
#cfaa	#cfaa
#ummerfayaz	#ummerfayaz
#cfml	#cfml
#ihatelife	#ihatelife
#jasminators	#jasminators
#workoverload	#workoverload
#ughhhh	#ughhhh
#yeg	#yeg
#tcap	#tcap
#smfh	#smfh
#kmt	#kmt
#renters	#renters
#rentstrike	#rentstrike
#rentfree	#rentfree
#socialsquare	#socialsquare
#apartment	#apartment
#property	#property
#renting	#renting
#thighs	#thighs
#toto	#toto
#landlord	#landlord
#rentrelief	#rentrelief
#realestate	#realestate
#rentcontrol	#rentcontrol
#defender	#defender
#landrover	#landrover
#dmmmash	#dmmmash
#humanrightsdefender	#humanrightsdefender
#gamergear	#gamergear
#upscale	#upscale
#jamontv	#jamontv
#offroad	#offroad
#landcruiser	#landcruiser
#spectre	#spectre
#striker	#striker
#defenders	#defenders
#stcyr	#stcyr
#bitdefender	#bitdefender
#hilux	#hilux
#voltronlegendarydefender	#voltronlegendarydefender
#cine	#cine
#laggayivaat	#laggayivaat
#kycine	#kycine
#soompiawards2015	#soompiawards2015
#radionightitaly	#radionightitaly
#spain	#spain
#cwc19	#cwc19
#clipstartv	#clipstartv
#valladolid	#valladolid
#zeecineawards2018	#zeecineawards2018
#movies	#movies
#zeecineawards	#zeecineawards
#zeecineawards2016	#zeecineawards2016
#pyravids	#pyravids
#cinephiletweets	#cinephiletweets
#cinemax	#cinemax
#filmnews	#filmnews
#hallouween	#hallouween
#apology	#apology
#sorryday	#sorryday
#dolceamoreforgive	#dolceamoreforgive
#fb	#fb
#survivorsremorse	#survivorsremorse
#apologize	#apologize
#apologies	#apologies
#youthstrike4climate	#youthstrike4climate
#ikon	#ikon
#idealcutinsg	#idealcutinsg
#blowback	#blowback
#projectforgive	#projectforgive
#notanapology	#notanapology
#iowahawkeyes	#iowahawkeyes
#anthem	#anthem
#apologiesinadvance	#apologiesinadvance
#crisisoninfiniteearths	#crisisoninfiniteearths
#earthsfinest	#earthsfinest
#l4g	#l4g
#parthsmusicalrise	#parthsmusicalrise
#tomanews	#tomanews
#loco	#loco
#infiniteeffectmanila	#infiniteeffectmanila
#mishapocalypse	#mishapocalypse
#crisisonearthx	#crisisonearthx
#infinite	#infinite
#heroesvsaliens	#heroesvsaliens
#elseworlds	#elseworlds
#arrow	#arrow
#rareearths	#rareearths
#theflash	#theflash
#acrylic	#acrylic
#painting	#painting
#acrylics	#acrylics
#pleinair	#pleinair
#oilpainting	#oilpainting
#irisunart	#irisunart
#lawstudents	#lawstudents
#broccoli	#broccoli
#abstract	#abstract
#acrylicnails	#acrylicnails
#acrylicpainting	#acrylicpainting
#paints	#paints
#hondalove	#hondalove
#abstractpainting	#abstractpainting
#oilpaint	#oilpaint
#australiaonfire	#australiaonfire
#burning	#burning
#knockers	#knockers
#basicattentiontoken	#basicattentiontoken
#brickell	#brickell
#covid19australia	#covid19australia
#selfdrivingcars	#selfdrivingcars
#selfdriving	#selfdriving
#driverlesscars	#driverlesscars
#autonomousvehicles	#autonomousvehicles
#autonomousdriving	#autonomousdriving
#selfdrivingcar	#selfdrivingcar
#psjhjobs	#psjhjobs
#trumpcrimescommission	#trumpcrimescommission
#autonomouscar	#autonomouscar
#autonomouscars	#autonomouscars
#driving	#driving
#hancock	#hancock
#thingstodo	#thingstodo
#mappinings	#mappinings
#careerandbusiness	#careerandbusiness
#citiesfridays	#citiesfridays
#thingsiliketodo	#thingsiliketodo
#nothingtodo	#nothingtodo
#whattodo	#whattodo
#thingstodobeforeidie	#thingstodobeforeidie
#billerica	#billerica
#birdlife	#birdlife
#today	#today
#t2d2d	#t2d2d
#miui	#miui
#betterthingstodo	#betterthingstodo
#myob	#myob
#talktohobbie	#talktohobbie
#makeamericasaneagain	#makeamericasaneagain
#byoc	#byoc
#freespirit	#freespirit
#mybodymyrights	#mybodymyrights
#justsaying	#justsaying
#omb	#omb
#training	#training
#erasmusplus	#erasmusplus
#waytogomeng	#waytogomeng
#ob	#ob
#mybodymychoice	#mybodymychoice
#myo	#myo
#howtopissmeoff	#howtopissmeoff
#thanks	#thanks
#thewrightstuff	#thewrightstuff
#foundpet	#foundpet
#recycling	#recycling
#tropics	#tropics
#green	#green
#sustainability	#sustainability
#recycled	#recycled
#ewaste	#ewaste
#xfactor2016	#xfactor2016
#recycle	#recycle
#composting	#composting
#globalrecyclingday	#globalrecyclingday
#keepthevampsatno1	#keepthevampsatno1
#shameful	#shameful
#despicable	#despicable
#supremeloser	#supremeloser
#welcometonewyork	#welcometonewyork
#appalling	#appalling
#shamefull	#shamefull
#pioneernation	#pioneernation
#scandalous	#scandalous
#disgraceful	#disgraceful
#unforgivable	#unforgivable
#worstpresidentever	#worstpresidentever
#phenomradio	#phenomradio
#humiliating	#humiliating
#disgusting	#disgusting
#disgusted	#disgusted
#complicitcorruptgop	#complicitcorruptgop
#weloveyoutaylor	#weloveyoutaylor
#westandwithtaylor	#westandwithtaylor
#weloveyouhoseok	#weloveyouhoseok
#istandwithtaylor	#istandwithtaylor
#weloveyoujustin	#weloveyoujustin
#welovetaylorswift	#welovetaylorswift
#nbajam	#nbajam
#footslave	#footslave
#rwc15	#rwc15
#staystrongtaylor	#staystrongtaylor
#teamtaylor	#teamtaylor
#weloveyouharry	#weloveyouharry
#weloveyouseokjin	#weloveyouseokjin
#proudoftaylor	#proudoftaylor
#emabiggestfanstaylorswift	#emabiggestfanstaylorswift
#weloveyou	#weloveyou
#goingback	#goingback
#wannagoback	#wannagoback
#goback	#goback
#notgoingback	#notgoingback
#wanttogoback	#wanttogoback
#gobackpinarayi	#gobackpinarayi
#sosa	#sosa
#excited	#excited
#linkedmoms	#linkedmoms
#tbirdnation	#tbirdnation
#nflbound	#nflbound
#missitalready	#missitalready
#missedya	#missedya
#nogoingback	#nogoingback
#nevergoingback	#nevergoingback
#itsaboyfriendsjob	#itsaboyfriendsjob
#cop23	#cop23
#eyecontact	#eyecontact
#changeclimatechange	#changeclimatechange
#depressingchildrensbooks	#depressingchildrensbooks
#eachdayisavictorywhen	#eachdayisavictorywhen
#crimesagainsthumanity	#crimesagainsthumanity
#crimeagainsthumanity	#crimeagainsthumanity
#amharagenocide	#amharagenocide
#crimesagainstchildren	#crimesagainstchildren
#type2	#type2
#imposters	#imposters
#procycling	#procycling
#warcrime	#warcrime
#whatshappeninglnmyanmar	#whatshappeninglnmyanmar
#genocideingaza	#genocideingaza
#armenianwarcrimes	#armenianwarcrimes
#whatshappeninginmyanmar	#whatshappeninginmyanmar
#cardsagainsthumanity	#cardsagainsthumanity
#crimes	#crimes
#nationallottery	#nationallottery
#nationalsmileday	#nationalsmileday
#euromillions	#euromillions
#plasticfreejuly	#plasticfreejuly
#lotto	#lotto
#hlfsupported	#hlfsupported
#dvlottery	#dvlottery
#thankstoyou	#thankstoyou
#lotteryticket	#lotteryticket
#asurewin	#asurewin
#wouldnt	#wouldnt
#nationalstationeryweek	#nationalstationeryweek
#lotery	#lotery
#pendeja	#pendeja
#lotteryresults	#lotteryresults
#lottery	#lottery
#reactjs	#reactjs
#antiversary	#antiversary
#gift	#gift
#connormcdavid	#connormcdavid
#showtimeanimversary	#showtimeanimversary
#shotsaversary	#shotsaversary
#lord	#lord
#crazymofos	#crazymofos
#ajtaczek	#ajtaczek
#snowmageddon	#snowmageddon
#fightcamp	#fightcamp
#jltseries	#jltseries
#sipgrab	#sipgrab
#fambam	#fambam
#mifamilia	#mifamilia
#bam	#bam
#cousins	#cousins
#famlove	#famlove
#famished	#famished
#maza	#maza
#cantfuckingwait	#cantfuckingwait
#showingmyage	#showingmyage
#ddcahauntsjaitley	#ddcahauntsjaitley
#familyouting	#familyouting
#dolceamoresatotoolang	#dolceamoresatotoolang
#mccafe	#mccafe
#iamfamily	#iamfamily
#famalam	#famalam
#zzz	#zzz
#wewantaustinmahoneinitaly	#wewantaustinmahoneinitaly
#zzzzzz	#zzzzzz
#giddyup	#giddyup
#zzzzzzz	#zzzzzzz
#boutdatlife	#boutdatlife
#colu	#colu
#feelingtired	#feelingtired
#soexhausted	#soexhausted
#zzzzzzzzzzz	#zzzzzzzzzzz
#sooootired	#sooootired
#disrupttexts	#disrupttexts
#zzzz	#zzzz
#relax	#relax
#zzzzz	#zzzzz
#whooo	#whooo
#killary	#killary
#emailscandal	#emailscandal
#killery	#killery
#freeaafia	#freeaafia
#bambino	#bambino
#sethrichmurder	#sethrichmurder
#ary	#ary
#crookedhilary	#crookedhilary
#flirt4free	#flirt4free
#clinton	#clinton
#benghazi	#benghazi
#itinerary	#itinerary
#goldensombrero	#goldensombrero
#govote	#govote
#herpeshillary	#herpeshillary
#ecw	#ecw
#rarock	#rarock
#ilive2listen	#ilive2listen
#kannur	#kannur
#listenupng	#listenupng
#lovethatboy	#lovethatboy
#listen2	#listen2
#heartradiogr	#heartradiogr
#mustlisten	#mustlisten
#salmanstandsclear	#salmanstandsclear
#firstlisten	#firstlisten
#g4gnowplaying	#g4gnowplaying
#theunsignedmusicstation	#theunsignedmusicstation
#golisten	#golisten
#psycho	#psycho
#tcmparty	#tcmparty
#rhema	#rhema
#physco	#physco
#mobpsycho100	#mobpsycho100
#askpsychodad	#askpsychodad
#americanpsycho	#americanpsycho
#sheissonasty	#sheissonasty
#psychopath	#psychopath
#lamarathon	#lamarathon
#psychobitch	#psychobitch
#thriller	#thriller
#pldt	#pldt
#redvelvet	#redvelvet
#babies	#babies
#parenting	#parenting
#sugarbabies	#sugarbabies
#colleges	#colleges
#newborns	#newborns
#pittie	#pittie
#cutebabies	#cutebabies
#babycare	#babycare
#moms	#moms
#babiesofinstagram	#babiesofinstagram
#poorbabies	#poorbabies
#newmoms	#newmoms
#momtobe	#momtobe
#newparents	#newparents
#nobabies	#nobabies
#momlife	#momlife
#nite	#nite
#nitenite	#nitenite
#industrynite	#industrynite
#nighty	#nighty
#nighttwitter	#nighttwitter
#andes	#andes
#niteflirt	#niteflirt
#nhlallstargame	#nhlallstargame
#goodnight	#goodnight
#umra	#umra
#banfracking	#banfracking
#twd100nite	#twd100nite
#interested	#interested
#takingapplications	#takingapplications
#notinterested	#notinterested
#hushedwithjoeydevries	#hushedwithjoeydevries
#smartjumpinreveal	#smartjumpinreveal
#homestead	#homestead
#seriousinquiriesonly	#seriousinquiriesonly
#intrigued	#intrigued
#inks	#inks
#interest	#interest
#wrathofolympus	#wrathofolympus
#looking	#looking
#card	#card
#timyconcerned	#timyconcerned
#notstudying	#notstudying
#spend	#spend
#duvetday	#duvetday
#duvet	#duvet
#day1	#day1
#londontobrighton	#londontobrighton
#hustle411	#hustle411
#dayofrest	#dayofrest
#bahraini	#bahraini
#day	#day
#comfy	#comfy
#bedweather	#bedweather
#denimday	#denimday
#perfectnightin	#perfectnightin
#lazysundays	#lazysundays
#pajamaday	#pajamaday
#reminder	#reminder
#bycatch	#bycatch
#selfreminder	#selfreminder
#keepsupportcassiewinxs	#keepsupportcassiewinxs
#selfnote	#selfnote
#blono	#blono
#reminders	#reminders
#gentle	#gentle
#showtimewedgiveyouall	#showtimewedgiveyouall
#friendlyreminder	#friendlyreminder
#releasereminder	#releasereminder
#electricalengineering	#electricalengineering
#thesw	#thesw
#islamicreminder	#islamicreminder
#sixwordstory	#sixwordstory
#employeeownership	#employeeownership
#sixwordhorrorstory	#sixwordhorrorstory
#sixwordstories	#sixwordstories
#my5wordromancenovel	#my5wordromancenovel
#my4wordobituary	#my4wordobituary
#quote	#quote
#houseofcardsseason2	#houseofcardsseason2
#sixwords	#sixwords
#caiimecam	#caiimecam
#sixwordsadstory	#sixwordsadstory
#sixwordberniestory	#sixwordberniestory
#theblast	#theblast
#blast	#blast
#flacofair	#flacofair
#deductions	#deductions
#thesoundcheck	#thesoundcheck
#indiemusicblast	#indiemusicblast
#blastfromthepast	#blastfromthepast
#lisa20mparty	#lisa20mparty
#edm	#edm
#votebajablast	#votebajablast
#burnthestagethemovie	#burnthestagethemovie
#dance	#dance
#gawdmusic	#gawdmusic
#soundcheckiradio	#soundcheckiradio
#the	#the
#alwayshappens	#alwayshappens
#onblast	#onblast
#lmk	#lmk
#handmade	#handmade
#nlbecky	#nlbecky
#dmgame	#dmgame
#pls	#pls
#poinsettiabowl	#poinsettiabowl
#lemmeknow	#lemmeknow
#rtme	#rtme
#waytoohot	#waytoohot
#monkiekid	#monkiekid
#fwm	#fwm
#kikcode	#kikcode
#frustratedbjp	#frustratedbjp
#otracolumbus	#otracolumbus
#dm	#dm
#teamlean	#teamlean
#replytweet	#replytweet
#whoolywoodshuffle	#whoolywoodshuffle
#hmu	#hmu
#awesome	#awesome
#soawesome	#soawesome
#awesomeness	#awesomeness
#computers	#computers
#aacpsawesome	#aacpsawesome
#gaa	#gaa
#awesomebaby	#awesomebaby
#awesum	#awesum
#awesomesong	#awesomesong
#awesomemovie	#awesomemovie
#totallyawesome	#totallyawesome
#kindawesome	#kindawesome
#carrielam	#carrielam
#brendaleyland	#brendaleyland
#paisavasool	#paisavasool
#honourkilling	#honourkilling
#xitler	#xitler
#carrie	#carrie
#lam	#lam
#carrieunderwood	#carrieunderwood
#carriediaries	#carriediaries
#hkpolicestate	#hkpolicestate
#teamcarrie	#teamcarrie
#lauraloomer	#lauraloomer
#lorettalynch	#lorettalynch
#freefall	#freefall
#parisagreeement	#parisagreeement
#parisaccord	#parisaccord
#paris2024	#paris2024
#celebratehknkj	#celebratehknkj
#parisagreement	#parisagreement
#savealfieevans	#savealfieevans
#disneylandparis	#disneylandparis
#tennesseehateweek	#tennesseehateweek
#parisclimateaccord	#parisclimateaccord
#timothy	#timothy
#parisclimatedeal	#parisclimatedeal
#paris2015	#paris2015
#goodcause	#goodcause
#paris	#paris
#parisclimateagreement	#parisclimateagreement
#mosradionow	#mosradionow
#nowplayingonqclassics	#nowplayingonqclassics
#nowplayingonstarfm	#nowplayingonstarfm
#bestofhitsurbanradio	#bestofhitsurbanradio
#hamil	#hamil
#nowplayingconfident	#nowplayingconfident
#wantedly	#wantedly
#apollo8	#apollo8
#m4d	#m4d
#sla2015	#sla2015
#signingoff	#signingoff
#carbs	#carbs
#carbohydrates	#carbohydrates
#suspence	#suspence
#nocarbs	#nocarbs
#weightloss	#weightloss
#carb	#carb
#elsipogtogsolidarity	#elsipogtogsolidarity
#healthymeals	#healthymeals
#spartanswill	#spartanswill
#protein	#protein
#highprotein	#highprotein
#calories	#calories
#carbloading	#carbloading
#backtowork	#backtowork
#getbacktowork	#getbacktowork
#backtothegrind	#backtothegrind
#gotowork	#gotowork
#wreaths	#wreaths
#backtoreality	#backtoreality
#backtoschool	#backtoschool
#worklife	#worklife
#backtoback	#backtoback
#tuesdaymotivation	#tuesdaymotivation
#back2work	#back2work
#cbo	#cbo
#backtobusiness	#backtobusiness
#cskvssrh	#cskvssrh
#renewableenergy	#renewableenergy
#renewable	#renewable
#cleanenergy	#cleanenergy
#freebiomass	#freebiomass
#sustainableenergy	#sustainableenergy
#prayforfrance	#prayforfrance
#solar	#solar
#clubntycefridaynite	#clubntycefridaynite
#vocalnation	#vocalnation
#cleanpower	#cleanpower
#energy	#energy
#energy997	#energy997
#renewables	#renewables
#energyconservation	#energyconservation
#ttyl	#ttyl
#g2g	#g2g
#yl	#yl
#cheryl	#cheryl
#whaleshark	#whaleshark
#offthis	#offthis
#tealight	#tealight
#gmm	#gmm
#rickyl	#rickyl
#dueces	#dueces
#tonightimgettingoveryou	#tonightimgettingoveryou
#prayfornyc	#prayfornyc
#toodles	#toodles
#diabetes	#diabetes
#tweetlater	#tweetlater
#brb	#brb
#elongate	#elongate
#memes	#memes
#tooloud	#tooloud
#btsmemes	#btsmemes
#funnymemes	#funnymemes
#memesdaily	#memesdaily
#trivium	#trivium
#ffxivmemes	#ffxivmemes
#lolzmag	#lolzmag
#meme	#meme
#sentimental	#sentimental
#dankmemes	#dankmemes
#loveyouforever	#loveyouforever
#missyousomuch	#missyousomuch
#please	#please
#iwillalwaysloveyou	#iwillalwaysloveyou
#loveeternal	#loveeternal
#missyou	#missyou
#yellen	#yellen
#loveforever	#loveforever
#loveyoualways	#loveyoualways
#bestfriendsforever	#bestfriendsforever
#thankyou	#thankyou
#iwillloveyouforever	#iwillloveyouforever
#loveyouhaifawehbe	#loveyouhaifawehbe
#loveyou	#loveyou
#nopromises	#nopromises
#weloveyougaga	#weloveyougaga
#illloveyouforever	#illloveyouforever
#sekai	#sekai
#newspoll	#newspoll
#lmhbenchpart2	#lmhbenchpart2
#poll	#poll
#prelaw	#prelaw
#tasvotes	#tasvotes
#pollofpolls	#pollofpolls
#ausvotes	#ausvotes
#wpsparks	#wpsparks
#publishthepoll	#publishthepoll
#techjunkienews	#techjunkienews
#pollresultske	#pollresultske
#australiavotes	#australiavotes
#auspoll	#auspoll
#tippingpoint	#tippingpoint
#contestalert	#contestalert
#traveldorsetalert	#traveldorsetalert
#alert	#alert
#giveaway	#giveaway
#contestindia	#contestindia
#fajocontest	#fajocontest
#womenwontwheesht	#womenwontwheesht
#bmscontest	#bmscontest
#koblenz	#koblenz
#contest	#contest
#vrc	#vrc
#eventalert	#eventalert
#giveawayalert	#giveawayalert
#bombaychrissy	#bombaychrissy
#comiccontest	#comiccontest
#legal	#legal
#legalrights	#legalrights
#occupyinac	#occupyinac
#lawjobs	#lawjobs
#phehealthmatters	#phehealthmatters
#legalwriting	#legalwriting
#raleighncfree	#raleighncfree
#legaladvice	#legaladvice
#legalissues	#legalissues
#legalmarketing	#legalmarketing
#inhousecounsel	#inhousecounsel
#legaljobs	#legaljobs
#paralegal	#paralegal
#litigation	#litigation
#finallylegal	#finallylegal
#prize	#prize
#nobelprize2014	#nobelprize2014
#competition	#competition
#rttowin	#rttowin
#mastersystem	#mastersystem
#giveawayfriday	#giveawayfriday
#rickmansworth	#rickmansworth
#prizedraw	#prizedraw
#smallzysgfgprize	#smallzysgfgprize
#ovali	#ovali
#packersnation	#packersnation
#comping	#comping
#hackadayprize	#hackadayprize
#teacherprize	#teacherprize
#twoclassychics	#twoclassychics
#cashprize	#cashprize
#nosense	#nosense
#bmif2	#bmif2
#makesense	#makesense
#wtf	#wtf
#nocommonsense	#nocommonsense
#children	#children
#thisisdumb	#thisisdumb
#noreason	#noreason
#dontmakesense	#dontmakesense
#makesnosense	#makesnosense
#wheresthelogic	#wheresthelogic
#confusedaf	#confusedaf
#themixfc	#themixfc
#purpose	#purpose
#nosense8nonetflix	#nosense8nonetflix
#tweepectory	#tweepectory
#specialneeds	#specialneeds
#justice4cephus	#justice4cephus
#ttlsummit	#ttlsummit
#protecttxfragilekids	#protecttxfragilekids
#specialissue	#specialissue
#autismparent	#autismparent
#needs	#needs
#cerebralpalsy	#cerebralpalsy
#disabilities	#disabilities
#autismmom	#autismmom
#mtnhitmaker6	#mtnhitmaker6
#kindledailydeal	#kindledailydeal
#autism	#autism
#learningdisabilities	#learningdisabilities
#downssyndrome	#downssyndrome
#sospecial	#sospecial
#justlisted	#justlisted
#reimagine	#reimagine
#justsold	#justsold
#singlefamily	#singlefamily
#belucky	#belucky
#loveitorlistit	#loveitorlistit
#standardequitysale	#standardequitysale
#justannounced	#justannounced
#whoisonthelist	#whoisonthelist
#tmp	#tmp
#listed	#listed
#millet	#millet
#ijopenhomes	#ijopenhomes
#newlisting	#newlisting
#til	#til
#geekykaan	#geekykaan
#imold	#imold
#shoptilyoudrop	#shoptilyoudrop
#uselessknowledgetopossess	#uselessknowledgetopossess
#todayilearned	#todayilearned
#ftil	#ftil
#biggboss9	#biggboss9
#lifehacks	#lifehacks
#unl	#unl
#until	#until
#techcrunchjp	#techcrunchjp
#tiltheend	#tiltheend
#till	#till
#no	#no
#idk	#idk
#dontevenknow	#dontevenknow
#hcsmca	#hcsmca
#why	#why
#westbloomfield	#westbloomfield
#theformationworldtour	#theformationworldtour
#badkarma	#badkarma
#idek	#idek
#swimmer	#swimmer
#idc	#idc
#healthnews	#healthnews
#weird	#weird
#hair	#hair
#dunno	#dunno
#sometimesiwonder	#sometimesiwonder
#dontknow	#dontknow
#imaweirdo	#imaweirdo
#questionsiaskmyself	#questionsiaskmyself
#thesis	#thesis
#essayhelp	#essayhelp
#dissertation	#dissertation
#cosplayers	#cosplayers
#modimurdersdemocracy	#modimurdersdemocracy
#billnye	#billnye
#writemyessay	#writemyessay
#domyhomework	#domyhomework
#tracingph	#tracingph
#sanjuancapistrano	#sanjuancapistrano
#essay	#essay
#craigbrownphd	#craigbrownphd
#doctoral	#doctoral
#academicwriting	#academicwriting
#homework	#homework
#wanted	#wanted
#search	#search
#mostwanted	#mostwanted
#warrant	#warrant
#sugarbabywanted	#sugarbabywanted
#wantedworld	#wantedworld
#missing	#missing
#canadamissing	#canadamissing
#helpwanted	#helpwanted
#hunterhayes	#hunterhayes
#fugitivefriday	#fugitivefriday
#notwanted	#notwanted
#missingperson	#missingperson
#azadimubarak	#azadimubarak
#bernardtomic	#bernardtomic
#believeinmclarenhonda	#believeinmclarenhonda
#hunteriswanted	#hunteriswanted
#climateemergency	#climateemergency
#climatebreakdown	#climatebreakdown
#climatedebate	#climatedebate
#creativesunderstand	#creativesunderstand
#climateweek	#climateweek
#monsterweek	#monsterweek
#climate2014	#climate2014
#clestate	#clestate
#stopadani	#stopadani
#climatecrisis	#climatecrisis
#rescue	#rescue
#petrescue	#petrescue
#foster	#foster
#aftermarket	#aftermarket
#jobely	#jobely
#doggyrescue	#doggyrescue
#rescueready	#rescueready
#rescueanimals	#rescueanimals
#escapetothecountry	#escapetothecountry
#rescue116	#rescue116
#critterrescue	#critterrescue
#adopt	#adopt
#rescuecats	#rescuecats
#rescuedogs	#rescuedogs
#rushhour	#rushhour
#rushhourbiz	#rushhourbiz
#traffic	#traffic
#morningride	#morningride
#trafficjam	#trafficjam
#thecave	#thecave
#ihatetraffic	#ihatetraffic
#rushpike	#rushpike
#ttc	#ttc
#probowlvote	#probowlvote
#trafficsucks	#trafficsucks
#armysruinedkpopparty	#armysruinedkpopparty
#theweekendrush	#theweekendrush
#fucktraffic	#fucktraffic
#marissa	#marissa
#whole30	#whole30
#utedchat	#utedchat
#rushweek	#rushweek
#covid19nsw	#covid19nsw
#nswrfs	#nswrfs
#grassfire	#grassfire
#nsw15	#nsw15
#wnf	#wnf
#frnsw	#frnsw
#nsw	#nsw
#greysweatpantschallenge	#greysweatpantschallenge
#nswvotes	#nswvotes
#hazardreduction	#hazardreduction
#drsebi	#drsebi
#temblor	#temblor
#anonops	#anonops
#blotter	#blotter
#rblotr	#rblotr
#uofm	#uofm
#blogh	#blogh
#redsismica	#redsismica
#aftershock	#aftershock
#askbigsean	#askbigsean
#csem	#csem
#terremoto	#terremoto
#sismo	#sismo
#earthquake	#earthquake
#quake	#quake
#tremor	#tremor
#terremoti	#terremoti
#crytocurrency	#crytocurrency
#allamout	#allamout
#alttradex	#alttradex
#bitcoin	#bitcoin
#cryptokoffee	#cryptokoffee
#cryptoupdate	#cryptoupdate
#cryptocurrencynews	#cryptocurrencynews
#altcoins	#altcoins
#cryptorevolution	#cryptorevolution
#coinnounce	#coinnounce
#if12	#if12
#cryptotwitter	#cryptotwitter
#cryptohopper	#cryptohopper
#everyonethinksimweirdbecause	#everyonethinksimweirdbecause
#thisisyourday	#thisisyourday
#rockthisboat	#rockthisboat
#millions	#millions
#nkotb	#nkotb
#mydayismade	#mydayismade
#onthisday	#onthisday
#uninsured	#uninsured
#yourlifeyourway	#yourlifeyourway
#hopefortoday	#hopefortoday
#thisisyourtime	#thisisyourtime
#thisday	#thisday
#todayismyday	#todayismyday
#genesiswp	#genesiswp
#morningdevotional	#morningdevotional
#pastorbennyhinn	#pastorbennyhinn
#iprayforyoutoday	#iprayforyoutoday
#hearingvoices	#hearingvoices
#spiritualtalkradio	#spiritualtalkradio
#bevocalspeakup	#bevocalspeakup
#figureitout	#figureitout
#cheltenham2013	#cheltenham2013
#hearing	#hearing
#youthvoices	#youthvoices
#schizophrenia	#schizophrenia
#voices	#voices
#hearinglosshour	#hearinglosshour
#secwbb	#secwbb
#hearingloss	#hearingloss
#psychosis	#psychosis
#strzokhearing	#strzokhearing
#welisten	#welisten
#worldhearingday	#worldhearingday
#vzwvoices	#vzwvoices
#bigolive	#bigolive
#jaxa	#jaxa
#liveme	#liveme
#patscamp	#patscamp
#sfw	#sfw
#girl	#girl
#dolphin	#dolphin
#whereamazinghappens	#whereamazinghappens
#hellolikee	#hellolikee
#guy	#guy
#zzp	#zzp
#sensical	#sensical
#coindrop	#coindrop
#fc2live	#fc2live
#nhraonfox	#nhraonfox
#ticktock	#ticktock
#catchingfire	#catchingfire
#holdinmebackatmidnight	#holdinmebackatmidnight
#tko	#tko
#waitingsucks	#waitingsucks
#chrischristie	#chrischristie
#cantwaitanylonger	#cantwaitanylonger
#hmmmmm	#hmmmmm
#nyy	#nyy
#ticketing	#ticketing
#waitingpatiently	#waitingpatiently
#qanon	#qanon
#ticklish	#ticklish
#turnuptime	#turnuptime
#sherlockreacts	#sherlockreacts
#ticktock10	#ticktock10
#obama	#obama
#liloandstitch	#liloandstitch
#tomlinson	#tomlinson
#obamasummit	#obamasummit
#obamaamnesty	#obamaamnesty
#obamaspresidencyintwowords	#obamaspresidencyintwowords
#obamacare	#obamacare
#michelleobama	#michelleobama
#obamaoutdidtrump	#obamaoutdidtrump
#obamabidengate	#obamabidengate
#obamaadmin	#obamaadmin
#tweetlikeanigga	#tweetlikeanigga
#obamanation	#obamanation
#obamalegacy	#obamalegacy
#barackobama	#barackobama
#obama2012	#obama2012
#barrackobama	#barrackobama
#liarfromtheshire	#liarfromtheshire
#liar	#liar
#fromthearchive	#fromthearchive
#respecttheunit	#respecttheunit
#fromtheheart	#fromtheheart
#bangerhit	#bangerhit
#scottyfommarketing	#scottyfommarketing
#scottydoesnothing	#scottydoesnothing
#fromthesouth	#fromthesouth
#boristheliar	#boristheliar
#morrison	#morrison
#scottyfrommarketting	#scottyfrommarketting
#thebeastfromtheeast	#thebeastfromtheeast
#pathologicalliar	#pathologicalliar
#scottyfrommarketing	#scottyfrommarketing
#fromthearchives	#fromthearchives
#zedd	#zedd
#itsover	#itsover
#imdone	#imdone
#itsnotover	#itsnotover
#donewithlife	#donewithlife
#breakup	#breakup
#nationalstopharperday	#nationalstopharperday
#brookedavonduet	#brookedavonduet
#gladitsover	#gladitsover
#longgone	#longgone
#endofanera	#endofanera
#timetomoveon	#timetomoveon
#itsallover	#itsallover
#ridesharesea	#ridesharesea
#itsalmostover	#itsalmostover
#gameofthronesfinale	#gameofthronesfinale
#gameofthroneslive	#gameofthroneslive
#unionjgoodmorning	#unionjgoodmorning
#inkjunkeyz	#inkjunkeyz
#gameofthonesfinale	#gameofthonesfinale
#askanything	#askanything
#gamesofthrones	#gamesofthrones
#gameofthronesseason6	#gameofthronesseason6
#gameofthrones7	#gameofthrones7
#got	#got
#spoilers	#spoilers
#daenerys	#daenerys
#talkthethrones	#talkthethrones
#capricorn	#capricorn
#astrologyfacts	#astrologyfacts
#pluto	#pluto
#zodiacfacts	#zodiacfacts
#teamcapricorn	#teamcapricorn
#ascendant	#ascendant
#capricornseason	#capricornseason
#pisces	#pisces
#geminisignz	#geminisignz
#sungkyu	#sungkyu
#onlygod	#onlygod
#mathchat	#mathchat
#bennycapricorn	#bennycapricorn
#caplife	#caplife
#astrology	#astrology
#thefiresigns	#thefiresigns
#phdadvice	#phdadvice
#writinghelp	#writinghelp
#phdchat	#phdchat
#phds	#phds
#withaphd	#withaphd
#nightsorted	#nightsorted
#teachertips	#teachertips
#survivorculture	#survivorculture
#savelucifer	#savelucifer
#phd	#phd
#acwri	#acwri
#demphd	#demphd
#doctorate	#doctorate
#phdforum	#phdforum
#whatsapp	#whatsapp
#bbm	#bbm
#girlkik	#girlkik
#facebook	#facebook
#apps	#apps
#app	#app
#intlcheetahday	#intlcheetahday
#boingboing	#boingboing
#imreddie	#imreddie
#pizzalove	#pizzalove
#whatsappdown	#whatsappdown
#viber	#viber
#facebookmessenger	#facebookmessenger
#forwhatsapp	#forwhatsapp
#pakdata	#pakdata
#up	#up
#onup	#onup
#ketchingupwithiykeresa	#ketchingupwithiykeresa
#transsexuals	#transsexuals
#peanutallergy	#peanutallergy
#getup	#getup
#phinsup	#phinsup
#turned	#turned
#shut	#shut
#citizensunited	#citizensunited
#twitpicyourcleavage	#twitpicyourcleavage
#getupstandup	#getupstandup
#newbanger	#newbanger
#lockup	#lockup
#lightup	#lightup
#lightemup	#lightemup
#bloodaid	#bloodaid
#sanjivani	#sanjivani
#wewillrockyou	#wewillrockyou
#amazonfire	#amazonfire
#da5bloods	#da5bloods
#rakt	#rakt
#bloodmatters	#bloodmatters
#saturdayafternoongroove	#saturdayafternoongroove
#blood	#blood
#urgent	#urgent
#bld4needy	#bld4needy
#goodnightmoon	#goodnightmoon
#defcon	#defcon
#delhi	#delhi
#bloodforneedy	#bloodforneedy
#bloodhound	#bloodhound
#bloods	#bloods
#sensors	#sensors
#thatnigga	#thatnigga
#acm	#acm
#sensor	#sensor
#infrared	#infrared
#wearabletechnology	#wearabletechnology
#northamptonclown	#northamptonclown
#smarttech	#smarttech
#pompoms2	#pompoms2
#detect	#detect
#light	#light
#nature	#nature
#lightpainting	#lightpainting
#healthcheck	#healthcheck
#lightshowtromso	#lightshowtromso
#kodakbrownie	#kodakbrownie
#lightingtheworld	#lightingtheworld
#shinethelight	#shinethelight
#lightblue	#lightblue
#bluelight	#bluelight
#thelight	#thelight
#darkness	#darkness
#lowselfesteem	#lowselfesteem
#justkeepswimming	#justkeepswimming
#firstlight	#firstlight
#photographyfan	#photographyfan
#makeiteasy	#makeiteasy
#runsimple	#runsimple
#cnusocialmedia	#cnusocialmedia
#makeit	#makeit
#easydoesit	#easydoesit
#techfetch	#techfetch
#oscarjobs	#oscarjobs
#rectify	#rectify
#keepitsimple	#keepitsimple
#takeiteasy	#takeiteasy
#rekruiteasy	#rekruiteasy
#jujingyi	#jujingyi
#twitchaffiliate	#twitchaffiliate
#supportsmallstreamer	#supportsmallstreamer
#voteagt	#voteagt
#smallstreamers	#smallstreamers
#supportallstreamers	#supportallstreamers
#howtokeepyourgirl	#howtokeepyourgirl
#teamemmmmsie	#teamemmmmsie
#twitchraid	#twitchraid
#supportsmallerstreamers	#supportsmallerstreamers
#newstreamer	#newstreamer
#streamernetwork	#streamernetwork
#careers	#careers
#swedishcareers	#swedishcareers
#lifeinspiringcareers	#lifeinspiringcareers
#bloemfontein	#bloemfontein
#jobsandinternships	#jobsandinternships
#tmobilecareers	#tmobilecareers
#prayingforyou	#prayingforyou
#connectedcareers	#connectedcareers
#hotjobs	#hotjobs
#procomportjobs	#procomportjobs
#sayitaintso	#sayitaintso
#jobsearch	#jobsearch
#careersadvice	#careersadvice
#healthcareers	#healthcareers
#itcareers	#itcareers
#neverbernie	#neverbernie
#bernie	#bernie
#onlybernie	#onlybernie
#nevertrumporhillary	#nevertrumporhillary
#stillbernie	#stillbernie
#bernielostme	#bernielostme
#crazybernie	#crazybernie
#staceyabrams	#staceyabrams
#byebyebernie	#byebyebernie
#scout	#scout
#hbdfatherofcorruption	#hbdfatherofcorruption
#iwillneverstandwithher	#iwillneverstandwithher
#whyimnotvotingforhillary	#whyimnotvotingforhillary
#neverhillary	#neverhillary
#neverromney	#neverromney
#bernieorjill	#bernieorjill
#novels	#novels
#graphicnovels	#graphicnovels
#vanxmalic	#vanxmalic
#hottitles	#hottitles
#books	#books
#stonernovels	#stonernovels
#norway	#norway
#ficinprogress	#ficinprogress
#bookenticer	#bookenticer
#kindlebooks	#kindlebooks
#soros	#soros
#romance	#romance
#fictionbooks	#fictionbooks
#kindle	#kindle
#romancenovels	#romancenovels
#shortstories	#shortstories
#grist	#grist
#birthday	#birthday
#birthdaybitch	#birthdaybitch
#jhopebirthday	#jhopebirthday
#birthdayprincess	#birthdayprincess
#birthdayweekend	#birthdayweekend
#birthdaycelebration	#birthdaycelebration
#jihyo	#jihyo
#digitalinclusion	#digitalinclusion
#appalled	#appalled
#happybirthdayiansomerhalder	#happybirthdayiansomerhalder
#happybirthday	#happybirthday
#voltronlancebirthday	#voltronlancebirthday
#birthdaytomorrow	#birthdaytomorrow
#friends	#friends
#bdaygirl	#bdaygirl
#birthdayselfie	#birthdayselfie
#happybirthdaygreg	#happybirthdaygreg
#banknifty	#banknifty
#stocksmarket	#stocksmarket
#bank	#bank
#nifty50	#nifty50
#bankindia	#bankindia
#shifty	#shifty
#travelphotography	#travelphotography
#afcu23	#afcu23
#nibbles	#nibbles
#mamaccount	#mamaccount
#sensex	#sensex
#truehedge	#truehedge
#nifty	#nifty
#clickbank	#clickbank
#makingbank	#makingbank
#askamell	#askamell
#manifestation	#manifestation
#rio2016paralympics	#rio2016paralympics
#reshopmanifest	#reshopmanifest
#loa	#loa
#whenwillitstop	#whenwillitstop
#manifesting	#manifesting
#manifestivities	#manifestivities
#webhitshour	#webhitshour
#spiritualawakening	#spiritualawakening
#pneumonia	#pneumonia
#dailypropheticword	#dailypropheticword
#stank	#stank
#lawofattraction	#lawofattraction
#manifest	#manifest
#newreleases	#newreleases
#upcomingreleases	#upcomingreleases
#newrelease	#newrelease
#usavcan	#usavcan
#newreleasetuesday	#newreleasetuesday
#hotnewreads	#hotnewreads
#togetherathome	#togetherathome
#hot	#hot
#steamnewrelease	#steamnewrelease
#musicbrainz	#musicbrainz
#newmusicmondays	#newmusicmondays
#jukeboxmusicupdates	#jukeboxmusicupdates
#hotnewrelease	#hotnewrelease
#releases	#releases
#saveme	#saveme
#trumpisalaughingstock	#trumpisalaughingstock
#trumpisamoron	#trumpisamoron
#trumpispathetic	#trumpispathetic
#trumpisadisgrace	#trumpisadisgrace
#trumpisanationaldisgrace	#trumpisanationaldisgrace
#trumpcollapse	#trumpcollapse
#trumpiswithyou	#trumpiswithyou
#thestaffordproject	#thestaffordproject
#trumpisanidiot	#trumpisanidiot
#trumpmeltdown	#trumpmeltdown
#dirtydutch	#dirtydutch
#happybirthdaymom	#happybirthdaymom
#trumpislosing	#trumpislosing
#trumpisaloser	#trumpisaloser
#biden2020	#biden2020
#trumpafact	#trumpafact
#getitdone	#getitdone
#getitgetit	#getitgetit
#msgsaysdohardwork	#msgsaysdohardwork
#goleafsgo	#goleafsgo
#getthingsdone	#getthingsdone
#geterdone	#geterdone
#getshitdone	#getshitdone
#letsgetitdone	#letsgetitdone
#conturbotaxpuedes	#conturbotaxpuedes
#getit	#getit
#showtimethetask	#showtimethetask
#farmersrprotest	#farmersrprotest
#workhard	#workhard
#autographhotels	#autographhotels
#gettingitdone	#gettingitdone
#timeforchange	#timeforchange
#changetime	#changetime
#winterfell	#winterfell
#timechange	#timechange
#africa	#africa
#women	#women
#wewantchange	#wewantchange
#timeforachange	#timeforachange
#voteforchange	#voteforchange
#mrengager	#mrengager
#arsenal	#arsenal
#ndp	#ndp
#time4change	#time4change
#ready4change	#ready4change
#happynewyear2020	#happynewyear2020
#happynewyear2016	#happynewyear2016
#newyearseve	#newyearseve
#happynewyear2021	#happynewyear2021
#happynewyear	#happynewyear
#tiva	#tiva
#newyear	#newyear
#eyetracking	#eyetracking
#pallet	#pallet
#happy2019	#happy2019
#happynewyear2018	#happynewyear2018
#merrychristmas2020	#merrychristmas2020
#hello2021	#hello2021
#happynewyear2019	#happynewyear2019
#wisdom	#wisdom
#wordsofwisdom	#wordsofwisdom
#weekendwisdom	#weekendwisdom
#wisdomteeth	#wisdomteeth
#wisdomteethprobs	#wisdomteethprobs
#arbwisdom	#arbwisdom
#cartridges	#cartridges
#breezersoundhike	#breezersoundhike
#inspirationalquotes	#inspirationalquotes
#wfd2014	#wfd2014
#inspirationalquote	#inspirationalquote
#wisdomjobs	#wisdomjobs
#motivationquotes	#motivationquotes
#toolittletoolate	#toolittletoolate
#bigtentournament	#bigtentournament
#hypocrisy	#hypocrisy
#toolate	#toolate
#tooearly	#tooearly
#badtiming	#badtiming
#jojo	#jojo
#nottoolate	#nottoolate
#toolatenow	#toolatenow
#wetindey	#wetindey
#spoketoosoon	#spoketoosoon
#realtors	#realtors
#didyoufeelit	#didyoufeelit
#invesments	#invesments
#earthquake2016	#earthquake2016
#quakechampions	#quakechampions
#sabahquake	#sabahquake
#renewmanifest	#renewmanifest
#earthquakeapp	#earthquakeapp
#hmrd	#hmrd
#okquake	#okquake
#earthquake2015	#earthquake2015
#parentalalienation	#parentalalienation
#sharedparenting	#sharedparenting
#growingupwithdivorcedparents	#growingupwithdivorcedparents
#childabuse	#childabuse
#parental	#parental
#pas	#pas
#aliensharks	#aliensharks
#phytoplankton	#phytoplankton
#maitai	#maitai
#parentalleave	#parentalleave
#familyseparation	#familyseparation
#childabduction	#childabduction
#alienation	#alienation
#divorce	#divorce
#foursome	#foursome
#streetphotography	#streetphotography
#encorezendaya	#encorezendaya
#streetphoto	#streetphoto
#urbanphotography	#urbanphotography
#streetarteverywhere	#streetarteverywhere
#redemptionforblacksiren	#redemptionforblacksiren
#streetart	#streetart
#street	#street
#bwphotography	#bwphotography
#bnwphotography	#bnwphotography
#streettogs	#streettogs
#streetphotographer	#streetphotographer
#shestooyoungforyoubro	#shestooyoungforyoubro
#decoration	#decoration
#homeinterior	#homeinterior
#fastpitch	#fastpitch
#interiordesign	#interiordesign
#homedecoration	#homedecoration
#liberating	#liberating
#decorated	#decorated
#decorations	#decorations
#architecture	#architecture
#home	#home
#picsart	#picsart
#homedecorideas	#homedecorideas
#decoratingideas	#decoratingideas
#christmasdecorations	#christmasdecorations
#homedecorating	#homedecorating
#series	#series
#somosunday	#somosunday
#newseries	#newseries
#fttb	#fttb
#tourseries	#tourseries
#series3	#series3
#mystery	#mystery
#blackseries	#blackseries
#musemon	#musemon
#tv	#tv
#summerseries	#summerseries
#bookseries	#bookseries
#crimefic	#crimefic
#uwmaseries	#uwmaseries
#wwesurvivorseries	#wwesurvivorseries
#tvseries	#tvseries
#neverlookback	#neverlookback
#bedroomfloor	#bedroomfloor
#m4	#m4
#nolookingback	#nolookingback
#nevergoback	#nevergoback
#nevercomingback	#nevercomingback
#movingforward	#movingforward
#blog	#blog
#alwaysudf	#alwaysudf
#dontlookback	#dontlookback
#noregrets	#noregrets
#msgwishesongurumadiwas	#msgwishesongurumadiwas
#noturningback	#noturningback
#buffalo	#buffalo
#buffaloweather	#buffaloweather
#wwebuffalo	#wwebuffalo
#newyork	#newyork
#albany	#albany
#buffalove	#buffalove
#buffalowings	#buffalowings
#chickenwings	#chickenwings
#randomfact	#randomfact
#buffalosnow	#buffalosnow
#buffalosabres	#buffalosabres
#onebuffalo	#onebuffalo
#buffalobills	#buffalobills
#lswho	#lswho
#investigatetrump	#investigatetrump
#iblife	#iblife
#connectthedots	#connectthedots
#treasontrump	#treasontrump
#americansfindtrumpguilty	#americansfindtrumpguilty
#arresttrump	#arresttrump
#january6thcommission	#january6thcommission
#criminaltrump	#criminaltrump
#trumpcrimefamily	#trumpcrimefamily
#europeancommission	#europeancommission
#trumptreason	#trumptreason
#tcc	#tcc
#trumpcrimefamilyforprison	#trumpcrimefamilyforprison
#wiltshirejobs	#wiltshirejobs
#trumpconspired	#trumpconspired
#imho	#imho
#fwiw	#fwiw
#gkmc	#gkmc
#ilkeston	#ilkeston
#gmk	#gmk
#ho	#ho
#joycequote	#joycequote
#hoho	#hoho
#hohoho	#hohoho
#soc119	#soc119
#hiphop	#hiphop
#yummies	#yummies
#personalopinion	#personalopinion
#justmyopinion	#justmyopinion
#somethinggreater	#somethinggreater
#findgodwithin	#findgodwithin
#playstationplus	#playstationplus
#freeonlinegames	#freeonlinegames
#oldpeople	#oldpeople
#minotaur	#minotaur
#gamingcards	#gamingcards
#consoles	#consoles
#playstationnetwork	#playstationnetwork
#podcaster	#podcaster
#playstationnation	#playstationnation
#justinuseustream	#justinuseustream
#fanschoicenatasha	#fanschoicenatasha
#gaming	#gaming
#psplus	#psplus
#hairdressing	#hairdressing
#playstationclassic	#playstationclassic
#xboxgamepass	#xboxgamepass
#hillary	#hillary
#hillary2016	#hillary2016
#hillaryliesmatter	#hillaryliesmatter
#corrupthillary	#corrupthillary
#hillaryemails	#hillaryemails
#crookedhillary	#crookedhillary
#hillaryclinton	#hillaryclinton
#hillaryforprison2016	#hillaryforprison2016
#hillary4prison2016	#hillary4prison2016
#stopaapihate	#stopaapihate
#azadkashmir	#azadkashmir
#hillaryrottenclinton	#hillaryrottenclinton
#tatmadaw	#tatmadaw
#hillary2020	#hillary2020
#unitedingdom	#unitedingdom
#ucan	#ucan
#karanjohar	#karanjohar
#jobsite4u	#jobsite4u
#uk	#uk
#kentuckyjobs	#kentuckyjobs
#prev	#prev
#tacticalstrategic	#tacticalstrategic
#searchukjobs	#searchukjobs
#theblackprince	#theblackprince
#unitedcenter	#unitedcenter
#unitedxxiv	#unitedxxiv
#dentists	#dentists
#unitedarmy	#unitedarmy
#labours	#labours
#verseoftheday	#verseoftheday
#scriptureoftheday	#scriptureoftheday
#lyricsoftheday	#lyricsoftheday
#notforme	#notforme
#assholeoftheday	#assholeoftheday
#babeoftheday	#babeoftheday
#amen	#amen
#hemelhempstead	#hemelhempstead
#scripture	#scripture
#dailyverse	#dailyverse
#poemoftheday	#poemoftheday
#todaysword	#todaysword
#waveupgrade	#waveupgrade
#songoftheday	#songoftheday
#scripturesunday	#scripturesunday
#darktolight	#darktolight
#wwg1wga	#wwg1wga
#hiddenhashtags	#hiddenhashtags
#greatawakeningworldwide	#greatawakeningworldwide
#lightthedark	#lightthedark
#connectedcars	#connectedcars
#darkto	#darkto
#survivornz	#survivornz
#thegreatawakening	#thegreatawakening
#deepstateexposed	#deepstateexposed
#truthiscoming	#truthiscoming
#gorgeousgiveaway	#gorgeousgiveaway
#sweepstakes	#sweepstakes
#macbarbie07giveaway	#macbarbie07giveaway
#nbsgiveaway	#nbsgiveaway
#collection	#collection
#etsyshopping	#etsyshopping
#winmygiftlist	#winmygiftlist
#rexmanningday	#rexmanningday
#rafflecopter	#rafflecopter
#csgogiveaway	#csgogiveaway
#fridaygiveaway	#fridaygiveaway
#giveway	#giveway
#enter2win	#enter2win
#cacargiveaway	#cacargiveaway
#escapefromtarkov	#escapefromtarkov
#zenon	#zenon
#sarkarkondattam	#sarkarkondattam
#escapethenight	#escapethenight
#sorryselenafrombeliebers	#sorryselenafrombeliebers
#eft	#eft
#destinythegame	#destinythegame
#arksurvivalevolved	#arksurvivalevolved
#escaperooms	#escaperooms
#pair	#pair
#subnautica	#subnautica
#fromcatchow	#fromcatchow
#escapefromwonderland	#escapefromwonderland
#omshanti	#omshanti
#smallstreamer	#smallstreamer
#sarkoholics	#sarkoholics
#steamkey	#steamkey
#grow	#grow
#growthhack	#growthhack
#learnandgrow	#learnandgrow
#letsgrow	#letsgrow
#growjune	#growjune
#gobrewers	#gobrewers
#womengrow	#womengrow
#growthhacker	#growthhacker
#growtogether	#growtogether
#creativitybooster	#creativitybooster
#freegamingpc	#freegamingpc
#growsome	#growsome
#growgolf	#growgolf
#texlege	#texlege
#growers	#growers
#mcfc	#mcfc
#animationhistory	#animationhistory
#alaskanmalamute	#alaskanmalamute
#phillysportsbirthday	#phillysportsbirthday
#parkhaejin	#parkhaejin
#onthisday1940	#onthisday1940
#onthisdayinhistory	#onthisdayinhistory
#twitterstorians	#twitterstorians
#onkokonsaghthisweek	#onkokonsaghthisweek
#hadtobesaid	#hadtobesaid
#thisdayingahistory	#thisdayingahistory
#thisdaythatyear	#thisdaythatyear
#f1	#f1
#stillness	#stillness
#meditating	#meditating
#oneness	#oneness
#heartfulness	#heartfulness
#seriousshit	#seriousshit
#contemplation	#contemplation
#stinsights	#stinsights
#communities	#communities
#meditation	#meditation
#msgsaysdomeditation	#msgsaysdomeditation
#jokpeme	#jokpeme
#eerie	#eerie
#serenity	#serenity
#illness	#illness
#stlouis	#stlouis
#transcendentalmeditation	#transcendentalmeditation
#nfs	#nfs
#yps	#yps
#thewarriors	#thewarriors
#stoploss	#stoploss
#rfs	#rfs
#mvatransport	#mvatransport
#hugecock	#hugecock
#psybulagbulagan	#psybulagbulagan
#nswf	#nswf
#karaoke	#karaoke
#churchtech	#churchtech
#jedoom	#jedoom
#votepedey	#votepedey
#worship	#worship
#chstech	#chstech
#sabar	#sabar
#triathletes	#triathletes
#church	#church
#stumin	#stumin
#churchcamp	#churchcamp
#pasoccer	#pasoccer
#worshipleader	#worshipleader
#churchflow	#churchflow
#boisefreestuff	#boisefreestuff
#churchonline	#churchonline
#churchlife	#churchlife
#nowministering	#nowministering
#determination	#determination
#commitment	#commitment
#selfmotivation	#selfmotivation
#disciplineequalsfreedom	#disciplineequalsfreedom
#selfdetermination	#selfdetermination
#motivation	#motivation
#perserverance	#perserverance
#hgjamfest	#hgjamfest
#dedication	#dedication
#otwolcommitment	#otwolcommitment
#clontarf	#clontarf
#dontquit	#dontquit
#justask	#justask
#thevoicekids2ph	#thevoicekids2ph
#familytime	#familytime
#famtime	#famtime
#fatherdaughtertime	#fatherdaughtertime
#lovemyfamily	#lovemyfamily
#familytimes	#familytimes
#happyfamily	#happyfamily
#mymotheralwaystoldme	#mymotheralwaystoldme
#familytimewithkapilsharma	#familytimewithkapilsharma
#ausvbra	#ausvbra
#aztecmbb	#aztecmbb
#onefamily	#onefamily
#firstfamily	#firstfamily
#dungeonsanddragons	#dungeonsanddragons
#lods	#lods
#dunedin	#dunedin
#dragons	#dragons
#imaginedragons	#imaginedragons
#dundalkfc	#dundalkfc
#rpg	#rpg
#fantasticradiouk	#fantasticradiouk
#pathfinderrpg	#pathfinderrpg
#txdot	#txdot
#dnd5e	#dnd5e
#dunlop	#dunlop
#godragons	#godragons
#dnd	#dnd
#dungeonmaster	#dungeonmaster
#rehobothbeach	#rehobothbeach
#thisismylife	#thisismylife
#thestoryofmylife	#thestoryofmylife
#lovemylife	#lovemylife
#mylifebelike	#mylifebelike
#alduballmylife	#alduballmylife
#mylyfe	#mylyfe
#shameontimesnow	#shameontimesnow
#teamfairyrose	#teamfairyrose
#mylifeinatweet	#mylifeinatweet
#allmylife	#allmylife
#noreopenforstudents	#noreopenforstudents
#fuckmylife	#fuckmylife
#tfbjp	#tfbjp
#ihavenolife	#ihavenolife
#aldubbeattheodds	#aldubbeattheodds
#mightymorphinpowerrangers	#mightymorphinpowerrangers
#powerrangersmovie	#powerrangersmovie
#happykathnielday	#happykathnielday
#morph	#morph
#redranger	#redranger
#mmpr	#mmpr
#gogopowerrangers	#gogopowerrangers
#musiclover	#musiclover
#supermegaforce	#supermegaforce
#itsmorphintime	#itsmorphintime
#rockets50	#rockets50
#powerrangers	#powerrangers
#proposal	#proposal
#weddinginvitation	#weddinginvitation
#marriage	#marriage
#theproposal	#theproposal
#otwoltheproposal	#otwoltheproposal
#christmasinaday	#christmasinaday
#engagement	#engagement
#pllproposal	#pllproposal
#propose	#propose
#proposals	#proposals
#engaged	#engaged
#fomo	#fomo
#thingsyoudontsayasapolitician	#thingsyoudontsayasapolitician
#rbooks	#rbooks
#rakuafl	#rakuafl
#rmusic	#rmusic
#bookschannel	#bookschannel
#booklog	#booklog
#unwrapjoy	#unwrapjoy
#kbooks	#kbooks
#everestbasecamp	#everestbasecamp
#dijsselbloem	#dijsselbloem
#poweroflove	#poweroflove
#rrebook	#rrebook
#codeblue	#codeblue
#rfootball	#rfootball
#microcap	#microcap
#wethepeople	#wethepeople
#wetheppl	#wetheppl
#wethepeoplemarch	#wethepeoplemarch
#resistanceunited	#resistanceunited
#impeachtrumpandpencenow	#impeachtrumpandpencenow
#givethepeoplewhattheywant	#givethepeoplewhattheywant
#gooddaybymew	#gooddaybymew
#takeourcountryback	#takeourcountryback
#theresistance	#theresistance
#needtoimpeach	#needtoimpeach
#wearethepeople	#wearethepeople
#camsten	#camsten
#theorginals	#theorginals
#found	#found
#missingpets	#missingpets
#finallyfoundsomeone	#finallyfoundsomeone
#modex	#modex
#lostpet	#lostpet
#founddogs	#founddogs
#foundyou	#foundyou
#stockingfiller	#stockingfiller
#foundcats	#foundcats
#tx	#tx
#founddog	#founddog
#foundit	#foundit
#pet	#pet
#maymayglamorousat20	#maymayglamorousat20
#foundlostdogs	#foundlostdogs
#btc	#btc
#cointracker	#cointracker
#bitcoincash	#bitcoincash
#goodfilm	#goodfilm
#bitcoinmining	#bitcoinmining
#hitbtc	#hitbtc
#ibtc	#ibtc
#shrenal	#shrenal
#eth	#eth
#safebtc	#safebtc
#justice4btc	#justice4btc
#pipeline	#pipeline
#binaryfest	#binaryfest
#mtc	#mtc
#bitcoinarbitrage	#bitcoinarbitrage
#loseit	#loseit
#losingit	#losingit
#toolegittoquit	#toolegittoquit
#loseweightfast	#loseweightfast
#lostit	#lostit
#greatwar	#greatwar
#christianmingleusernames	#christianmingleusernames
#amas	#amas
#lockitorloseit	#lockitorloseit
#endorphins	#endorphins
#nothingtolose	#nothingtolose
#endomondo	#endomondo
#bodyfat	#bodyfat
#fatburn	#fatburn
#cardiotrainer	#cardiotrainer
#mothers	#mothers
#grandmothers	#grandmothers
#mothersrecipes	#mothersrecipes
#mommies	#mommies
#mamasday	#mamasday
#motherslove	#motherslove
#gratitudetoallmothers	#gratitudetoallmothers
#motherday	#motherday
#caliclasico	#caliclasico
#momsday	#momsday
#timeisflying	#timeisflying
#mothersday	#mothersday
#whatmotherswant	#whatmotherswant
#sears	#sears
#seniorcare	#seniorcare
#elderlycare	#elderlycare
#seniorpics	#seniorpics
#healthcareservices	#healthcareservices
#seniorhealth	#seniorhealth
#ufcvegas26	#ufcvegas26
#senior	#senior
#care	#care
#assistedliving	#assistedliving
#homecare	#homecare
#sochkekhelahai	#sochkekhelahai
#caregiving	#caregiving
#vegastowers	#vegastowers
#caregiver	#caregiver
#healthcareandmedicalservices	#healthcareandmedicalservices
#soldiers	#soldiers
#salute2pakarmymartyrs	#salute2pakarmymartyrs
#servicemembers	#servicemembers
#pxgtroops	#pxgtroops
#supportourveterans	#supportourveterans
#renewmindy	#renewmindy
#childsoldiers	#childsoldiers
#digitalsoldiers	#digitalsoldiers
#highriskcovid19	#highriskcovid19
#remembereveryonedeployed	#remembereveryonedeployed
#manteno	#manteno
#streetsoldiers	#streetsoldiers
#startups	#startups
#techstartup	#techstartup
#startupsmusic	#startupsmusic
#vc	#vc
#foodstartups	#foodstartups
#alkhobar	#alkhobar
#techstartups	#techstartups
#howto	#howto
#starups	#starups
#mentionsomeonegorgeous	#mentionsomeonegorgeous
#dontaskwhy	#dontaskwhy
#thingsidowhenilikeyou	#thingsidowhenilikeyou
#askwhydontwe	#askwhydontwe
#transformationtuesday	#transformationtuesday
#reasonwhysomeonewouldkillme	#reasonwhysomeonewouldkillme
#dontaskme	#dontaskme
#illstoptalkingtoyouif	#illstoptalkingtoyouif
#arsenalnews	#arsenalnews
#dontbemadatmebecause	#dontbemadatmebecause
#dontask	#dontask
#guycode	#guycode
#askwhy	#askwhy
#buccos	#buccos
#whatyoushouldknowaboutme	#whatyoushouldknowaboutme
#exoclubhouse	#exoclubhouse
#bakingsodauses	#bakingsodauses
#frosting	#frosting
#thelegendcontinues	#thelegendcontinues
#holidaybaking	#holidaybaking
#sdg5	#sdg5
#twitterbakealong	#twitterbakealong
#desserts	#desserts
#homebaking	#homebaking
#cake	#cake
#recipes	#recipes
#bakingchampionship	#bakingchampionship
#bakingsoda	#bakingsoda
#christmasbaking	#christmasbaking
#worldbakingday	#worldbakingday
#cupcake	#cupcake
#tiguan	#tiguan
#breakfreefromplastic	#breakfreefromplastic
#passonplastic	#passonplastic
#setthemfree	#setthemfree
#plastics	#plastics
#raidergang	#raidergang
#saudiarabia	#saudiarabia
#saynotoplastic	#saynotoplastic
#freefrom	#freefrom
#pbconfs1	#pbconfs1
#breakingfree	#breakingfree
#registertovote	#registertovote
#sww17	#sww17
#powerofourvote	#powerofourvote
#ge2015	#ge2015
#righttovote	#righttovote
#seetimaar	#seetimaar
#ge2017	#ge2017
#govotetn	#govotetn
#register2vote	#register2vote
#nationalvoterregistrationday	#nationalvoterregistrationday
#votebeto	#votebeto
#hometovote	#hometovote
#stayinline	#stayinline
#voteto	#voteto
#didyouknow	#didyouknow
#diduknow	#diduknow
#factoftheday	#factoftheday
#doyouknow	#doyouknow
#youneverknow	#youneverknow
#doiknowyou	#doiknowyou
#tokyo7s	#tokyo7s
#didyouknowthat	#didyouknowthat
#interesting	#interesting
#dolt45	#dolt45
#hourcloppic	#hourcloppic
#interestingfacts	#interestingfacts
#ecofriendly	#ecofriendly
#hourfurrypic	#hourfurrypic
#fullhd	#fullhd
#hdtv	#hdtv
#depere	#depere
#mainland	#mainland
#cbb	#cbb
#beabotit	#beabotit
#movil	#movil
#hd	#hd
#hdinsight	#hdinsight
#ultrahd	#ultrahd
#torne	#torne
#bb	#bb
#mammal	#mammal
#monatebreakfastshow	#monatebreakfastshow
#touchhd	#touchhd
#flobcast	#flobcast
#africanentrepreneurs	#africanentrepreneurs
#startthespark	#startthespark
#africansrising	#africansrising
#youngentrepreneurs	#youngentrepreneurs
#enterpriseafrica	#enterpriseafrica
#notsurewhy	#notsurewhy
#morningworld	#morningworld
#africabiz	#africabiz
#besomebodytwitterchat	#besomebodytwitterchat
#entrepreneurs	#entrepreneurs
#african	#african
#digitalskills4africa	#digitalskills4africa
#africanamerican	#africanamerican
#africanproverb	#africanproverb
#africanamericans	#africanamericans
#googleshopping	#googleshopping
#treyburke	#treyburke
#shoppingonline	#shoppingonline
#shopping	#shopping
#bigcommerce	#bigcommerce
#apprenticeships	#apprenticeships
#googleadwords	#googleadwords
#googlesearch	#googlesearch
#searchenginemarketing	#searchenginemarketing
#onlineshopping	#onlineshopping
#moveonupuk	#moveonupuk
#ebookde	#ebookde
#adwords	#adwords
#paidsearch	#paidsearch
#ecommerce	#ecommerce
#onlineretail	#onlineretail
#hotdeal	#hotdeal
#hotdeals	#hotdeals
#dealoftheday	#dealoftheday
#bestdealsoftheday	#bestdealsoftheday
#csgohotdeals	#csgohotdeals
#ibasecretariat	#ibasecretariat
#sohot	#sohot
#hotukdeals	#hotukdeals
#pussyriot	#pussyriot
#goatsummer	#goatsummer
#chipolopolo	#chipolopolo
#hothot	#hothot
#coudeal	#coudeal
